要素数,実際の情報量,実際の情報量とarrayの差分,実際の情報量とndrrayの差分,配列のメモリ使用量,ndarrayのメモリ使用量
1,64,384,896,448,960
2,128,320,896,448,1024
3,192,640,896,832,1088
4,256,576,896,832,1152
5,320,512,896,832,1216
6,384,448,896,832,1280
7,448,384,896,832,1344
8,512,320,896,832,1408
9,576,768,896,1344,1472
10,640,704,896,1344,1536
11,704,640,896,1344,1600
12,768,576,896,1344,1664
13,832,512,896,1344,1728
14,896,448,896,1344,1792
15,960,384,896,1344,1856
16,1024,320,896,1344,1920
17,1088,768,896,1856,1984
18,1152,704,896,1856,2048
19,1216,640,896,1856,2112
20,1280,576,896,1856,2176
21,1344,512,896,1856,2240
22,1408,448,896,1856,2304
23,1472,384,896,1856,2368
24,1536,320,896,1856,2432
25,1600,768,896,2368,2496
26,1664,704,896,2368,2560
27,1728,640,896,2368,2624
28,1792,576,896,2368,2688
29,1856,512,896,2368,2752
30,1920,448,896,2368,2816
31,1984,384,896,2368,2880
32,2048,320,896,2368,2944
33,2112,768,896,2880,3008
34,2176,704,896,2880,3072
35,2240,640,896,2880,3136
36,2304,576,896,2880,3200
37,2368,512,896,2880,3264
38,2432,448,896,2880,3328
39,2496,384,896,2880,3392
40,2560,320,896,2880,3456
41,2624,1024,896,3648,3520
42,2688,960,896,3648,3584
43,2752,896,896,3648,3648
44,2816,832,896,3648,3712
45,2880,768,896,3648,3776
46,2944,704,896,3648,3840
47,3008,640,896,3648,3904
48,3072,576,896,3648,3968
49,3136,512,896,3648,4032
50,3200,448,896,3648,4096
51,3264,384,896,3648,4160
52,3328,320,896,3648,4224
53,3392,1024,896,4416,4288
54,3456,960,896,4416,4352
55,3520,896,896,4416,4416
56,3584,832,896,4416,4480
57,3648,768,896,4416,4544
58,3712,704,896,4416,4608
59,3776,640,896,4416,4672
60,3840,576,896,4416,4736
61,3904,512,896,4416,4800
62,3968,448,896,4416,4864
63,4032,384,896,4416,4928
64,4096,320,896,4416,4992
65,4160,1024,896,5184,5056
66,4224,960,896,5184,5120
67,4288,896,896,5184,5184
68,4352,832,896,5184,5248
69,4416,768,896,5184,5312
70,4480,704,896,5184,5376
71,4544,640,896,5184,5440
72,4608,576,896,5184,5504
73,4672,512,896,5184,5568
74,4736,448,896,5184,5632
75,4800,384,896,5184,5696
76,4864,320,896,5184,5760
77,4928,1280,896,6208,5824
78,4992,1216,896,6208,5888
79,5056,1152,896,6208,5952
80,5120,1088,896,6208,6016
81,5184,1024,896,6208,6080
82,5248,960,896,6208,6144
83,5312,896,896,6208,6208
84,5376,832,896,6208,6272
85,5440,768,896,6208,6336
86,5504,704,896,6208,6400
87,5568,640,896,6208,6464
88,5632,576,896,6208,6528
89,5696,512,896,6208,6592
90,5760,448,896,6208,6656
91,5824,384,896,6208,6720
92,5888,320,896,6208,6784
93,5952,1280,896,7232,6848
94,6016,1216,896,7232,6912
95,6080,1152,896,7232,6976
96,6144,1088,896,7232,7040
97,6208,1024,896,7232,7104
98,6272,960,896,7232,7168
99,6336,896,896,7232,7232
100,6400,832,896,7232,7296
101,6464,768,896,7232,7360
102,6528,704,896,7232,7424
103,6592,640,896,7232,7488
104,6656,576,896,7232,7552
105,6720,512,896,7232,7616
106,6784,448,896,7232,7680
107,6848,384,896,7232,7744
108,6912,320,896,7232,7808
109,6976,1536,896,8512,7872
110,7040,1472,896,8512,7936
111,7104,1408,896,8512,8000
112,7168,1344,896,8512,8064
113,7232,1280,896,8512,8128
114,7296,1216,896,8512,8192
115,7360,1152,896,8512,8256
116,7424,1088,896,8512,8320
117,7488,1024,896,8512,8384
118,7552,960,896,8512,8448
119,7616,896,896,8512,8512
120,7680,832,896,8512,8576
121,7744,768,896,8512,8640
122,7808,704,896,8512,8704
123,7872,640,896,8512,8768
124,7936,576,896,8512,8832
125,8000,512,896,8512,8896
126,8064,448,896,8512,8960
127,8128,384,896,8512,9024
128,8192,320,896,8512,9088
129,8256,1536,896,9792,9152
130,8320,1472,896,9792,9216
131,8384,1408,896,9792,9280
132,8448,1344,896,9792,9344
133,8512,1280,896,9792,9408
134,8576,1216,896,9792,9472
135,8640,1152,896,9792,9536
136,8704,1088,896,9792,9600
137,8768,1024,896,9792,9664
138,8832,960,896,9792,9728
139,8896,896,896,9792,9792
140,8960,832,896,9792,9856
141,9024,768,896,9792,9920
142,9088,704,896,9792,9984
143,9152,640,896,9792,10048
144,9216,576,896,9792,10112
145,9280,512,896,9792,10176
146,9344,448,896,9792,10240
147,9408,384,896,9792,10304
148,9472,320,896,9792,10368
149,9536,1792,896,11328,10432
150,9600,1728,896,11328,10496
151,9664,1664,896,11328,10560
152,9728,1600,896,11328,10624
153,9792,1536,896,11328,10688
154,9856,1472,896,11328,10752
155,9920,1408,896,11328,10816
156,9984,1344,896,11328,10880
157,10048,1280,896,11328,10944
158,10112,1216,896,11328,11008
159,10176,1152,896,11328,11072
160,10240,1088,896,11328,11136
161,10304,1024,896,11328,11200
162,10368,960,896,11328,11264
163,10432,896,896,11328,11328
164,10496,832,896,11328,11392
165,10560,768,896,11328,11456
166,10624,704,896,11328,11520
167,10688,640,896,11328,11584
168,10752,576,896,11328,11648
169,10816,512,896,11328,11712
170,10880,448,896,11328,11776
171,10944,384,896,11328,11840
172,11008,320,896,11328,11904
173,11072,2048,896,13120,11968
174,11136,1984,896,13120,12032
175,11200,1920,896,13120,12096
176,11264,1856,896,13120,12160
177,11328,1792,896,13120,12224
178,11392,1728,896,13120,12288
179,11456,1664,896,13120,12352
180,11520,1600,896,13120,12416
181,11584,1536,896,13120,12480
182,11648,1472,896,13120,12544
183,11712,1408,896,13120,12608
184,11776,1344,896,13120,12672
185,11840,1280,896,13120,12736
186,11904,1216,896,13120,12800
187,11968,1152,896,13120,12864
188,12032,1088,896,13120,12928
189,12096,1024,896,13120,12992
190,12160,960,896,13120,13056
191,12224,896,896,13120,13120
192,12288,832,896,13120,13184
193,12352,768,896,13120,13248
194,12416,704,896,13120,13312
195,12480,640,896,13120,13376
196,12544,576,896,13120,13440
197,12608,512,896,13120,13504
198,12672,448,896,13120,13568
199,12736,384,896,13120,13632
200,12800,320,896,13120,13696
201,12864,2304,896,15168,13760
202,12928,2240,896,15168,13824
203,12992,2176,896,15168,13888
204,13056,2112,896,15168,13952
205,13120,2048,896,15168,14016
206,13184,1984,896,15168,14080
207,13248,1920,896,15168,14144
208,13312,1856,896,15168,14208
209,13376,1792,896,15168,14272
210,13440,1728,896,15168,14336
211,13504,1664,896,15168,14400
212,13568,1600,896,15168,14464
213,13632,1536,896,15168,14528
214,13696,1472,896,15168,14592
215,13760,1408,896,15168,14656
216,13824,1344,896,15168,14720
217,13888,1280,896,15168,14784
218,13952,1216,896,15168,14848
219,14016,1152,896,15168,14912
220,14080,1088,896,15168,14976
221,14144,1024,896,15168,15040
222,14208,960,896,15168,15104
223,14272,896,896,15168,15168
224,14336,832,896,15168,15232
225,14400,768,896,15168,15296
226,14464,704,896,15168,15360
227,14528,640,896,15168,15424
228,14592,576,896,15168,15488
229,14656,512,896,15168,15552
230,14720,448,896,15168,15616
231,14784,384,896,15168,15680
232,14848,320,896,15168,15744
233,14912,2560,896,17472,15808
234,14976,2496,896,17472,15872
235,15040,2432,896,17472,15936
236,15104,2368,896,17472,16000
237,15168,2304,896,17472,16064
238,15232,2240,896,17472,16128
239,15296,2176,896,17472,16192
240,15360,2112,896,17472,16256
241,15424,2048,896,17472,16320
242,15488,1984,896,17472,16384
243,15552,1920,896,17472,16448
244,15616,1856,896,17472,16512
245,15680,1792,896,17472,16576
246,15744,1728,896,17472,16640
247,15808,1664,896,17472,16704
248,15872,1600,896,17472,16768
249,15936,1536,896,17472,16832
250,16000,1472,896,17472,16896
251,16064,1408,896,17472,16960
252,16128,1344,896,17472,17024
253,16192,1280,896,17472,17088
254,16256,1216,896,17472,17152
255,16320,1152,896,17472,17216
256,16384,1088,896,17472,17280
257,16448,1024,896,17472,17344
258,16512,960,896,17472,17408
259,16576,896,896,17472,17472
260,16640,832,896,17472,17536
261,16704,768,896,17472,17600
262,16768,704,896,17472,17664
263,16832,640,896,17472,17728
264,16896,576,896,17472,17792
265,16960,512,896,17472,17856
266,17024,448,896,17472,17920
267,17088,384,896,17472,17984
268,17152,320,896,17472,18048
269,17216,2816,896,20032,18112
270,17280,2752,896,20032,18176
271,17344,2688,896,20032,18240
272,17408,2624,896,20032,18304
273,17472,2560,896,20032,18368
274,17536,2496,896,20032,18432
275,17600,2432,896,20032,18496
276,17664,2368,896,20032,18560
277,17728,2304,896,20032,18624
278,17792,2240,896,20032,18688
279,17856,2176,896,20032,18752
280,17920,2112,896,20032,18816
281,17984,2048,896,20032,18880
282,18048,1984,896,20032,18944
283,18112,1920,896,20032,19008
284,18176,1856,896,20032,19072
285,18240,1792,896,20032,19136
286,18304,1728,896,20032,19200
287,18368,1664,896,20032,19264
288,18432,1600,896,20032,19328
289,18496,1536,896,20032,19392
290,18560,1472,896,20032,19456
291,18624,1408,896,20032,19520
292,18688,1344,896,20032,19584
293,18752,1280,896,20032,19648
294,18816,1216,896,20032,19712
295,18880,1152,896,20032,19776
296,18944,1088,896,20032,19840
297,19008,1024,896,20032,19904
298,19072,960,896,20032,19968
299,19136,896,896,20032,20032
300,19200,832,896,20032,20096
301,19264,768,896,20032,20160
302,19328,704,896,20032,20224
303,19392,640,896,20032,20288
304,19456,576,896,20032,20352
305,19520,512,896,20032,20416
306,19584,448,896,20032,20480
307,19648,384,896,20032,20544
308,19712,320,896,20032,20608
309,19776,3072,896,22848,20672
310,19840,3008,896,22848,20736
311,19904,2944,896,22848,20800
312,19968,2880,896,22848,20864
313,20032,2816,896,22848,20928
314,20096,2752,896,22848,20992
315,20160,2688,896,22848,21056
316,20224,2624,896,22848,21120
317,20288,2560,896,22848,21184
318,20352,2496,896,22848,21248
319,20416,2432,896,22848,21312
320,20480,2368,896,22848,21376
321,20544,2304,896,22848,21440
322,20608,2240,896,22848,21504
323,20672,2176,896,22848,21568
324,20736,2112,896,22848,21632
325,20800,2048,896,22848,21696
326,20864,1984,896,22848,21760
327,20928,1920,896,22848,21824
328,20992,1856,896,22848,21888
329,21056,1792,896,22848,21952
330,21120,1728,896,22848,22016
331,21184,1664,896,22848,22080
332,21248,1600,896,22848,22144
333,21312,1536,896,22848,22208
334,21376,1472,896,22848,22272
335,21440,1408,896,22848,22336
336,21504,1344,896,22848,22400
337,21568,1280,896,22848,22464
338,21632,1216,896,22848,22528
339,21696,1152,896,22848,22592
340,21760,1088,896,22848,22656
341,21824,1024,896,22848,22720
342,21888,960,896,22848,22784
343,21952,896,896,22848,22848
344,22016,832,896,22848,22912
345,22080,768,896,22848,22976
346,22144,704,896,22848,23040
347,22208,640,896,22848,23104
348,22272,576,896,22848,23168
349,22336,512,896,22848,23232
350,22400,448,896,22848,23296
351,22464,384,896,22848,23360
352,22528,320,896,22848,23424
353,22592,3328,896,25920,23488
354,22656,3264,896,25920,23552
355,22720,3200,896,25920,23616
356,22784,3136,896,25920,23680
357,22848,3072,896,25920,23744
358,22912,3008,896,25920,23808
359,22976,2944,896,25920,23872
360,23040,2880,896,25920,23936
361,23104,2816,896,25920,24000
362,23168,2752,896,25920,24064
363,23232,2688,896,25920,24128
364,23296,2624,896,25920,24192
365,23360,2560,896,25920,24256
366,23424,2496,896,25920,24320
367,23488,2432,896,25920,24384
368,23552,2368,896,25920,24448
369,23616,2304,896,25920,24512
370,23680,2240,896,25920,24576
371,23744,2176,896,25920,24640
372,23808,2112,896,25920,24704
373,23872,2048,896,25920,24768
374,23936,1984,896,25920,24832
375,24000,1920,896,25920,24896
376,24064,1856,896,25920,24960
377,24128,1792,896,25920,25024
378,24192,1728,896,25920,25088
379,24256,1664,896,25920,25152
380,24320,1600,896,25920,25216
381,24384,1536,896,25920,25280
382,24448,1472,896,25920,25344
383,24512,1408,896,25920,25408
384,24576,1344,896,25920,25472
385,24640,1280,896,25920,25536
386,24704,1216,896,25920,25600
387,24768,1152,896,25920,25664
388,24832,1088,896,25920,25728
389,24896,1024,896,25920,25792
390,24960,960,896,25920,25856
391,25024,896,896,25920,25920
392,25088,832,896,25920,25984
393,25152,768,896,25920,26048
394,25216,704,896,25920,26112
395,25280,640,896,25920,26176
396,25344,576,896,25920,26240
397,25408,512,896,25920,26304
398,25472,448,896,25920,26368
399,25536,384,896,25920,26432
400,25600,320,896,25920,26496
401,25664,3840,896,29504,26560
402,25728,3776,896,29504,26624
403,25792,3712,896,29504,26688
404,25856,3648,896,29504,26752
405,25920,3584,896,29504,26816
406,25984,3520,896,29504,26880
407,26048,3456,896,29504,26944
408,26112,3392,896,29504,27008
409,26176,3328,896,29504,27072
410,26240,3264,896,29504,27136
411,26304,3200,896,29504,27200
412,26368,3136,896,29504,27264
413,26432,3072,896,29504,27328
414,26496,3008,896,29504,27392
415,26560,2944,896,29504,27456
416,26624,2880,896,29504,27520
417,26688,2816,896,29504,27584
418,26752,2752,896,29504,27648
419,26816,2688,896,29504,27712
420,26880,2624,896,29504,27776
421,26944,2560,896,29504,27840
422,27008,2496,896,29504,27904
423,27072,2432,896,29504,27968
424,27136,2368,896,29504,28032
425,27200,2304,896,29504,28096
426,27264,2240,896,29504,28160
427,27328,2176,896,29504,28224
428,27392,2112,896,29504,28288
429,27456,2048,896,29504,28352
430,27520,1984,896,29504,28416
431,27584,1920,896,29504,28480
432,27648,1856,896,29504,28544
433,27712,1792,896,29504,28608
434,27776,1728,896,29504,28672
435,27840,1664,896,29504,28736
436,27904,1600,896,29504,28800
437,27968,1536,896,29504,28864
438,28032,1472,896,29504,28928
439,28096,1408,896,29504,28992
440,28160,1344,896,29504,29056
441,28224,1280,896,29504,29120
442,28288,1216,896,29504,29184
443,28352,1152,896,29504,29248
444,28416,1088,896,29504,29312
445,28480,1024,896,29504,29376
446,28544,960,896,29504,29440
447,28608,896,896,29504,29504
448,28672,832,896,29504,29568
449,28736,768,896,29504,29632
450,28800,704,896,29504,29696
451,28864,640,896,29504,29760
452,28928,576,896,29504,29824
453,28992,512,896,29504,29888
454,29056,448,896,29504,29952
455,29120,384,896,29504,30016
456,29184,320,896,29504,30080
457,29248,4352,896,33600,30144
458,29312,4288,896,33600,30208
459,29376,4224,896,33600,30272
460,29440,4160,896,33600,30336
461,29504,4096,896,33600,30400
462,29568,4032,896,33600,30464
463,29632,3968,896,33600,30528
464,29696,3904,896,33600,30592
465,29760,3840,896,33600,30656
466,29824,3776,896,33600,30720
467,29888,3712,896,33600,30784
468,29952,3648,896,33600,30848
469,30016,3584,896,33600,30912
470,30080,3520,896,33600,30976
471,30144,3456,896,33600,31040
472,30208,3392,896,33600,31104
473,30272,3328,896,33600,31168
474,30336,3264,896,33600,31232
475,30400,3200,896,33600,31296
476,30464,3136,896,33600,31360
477,30528,3072,896,33600,31424
478,30592,3008,896,33600,31488
479,30656,2944,896,33600,31552
480,30720,2880,896,33600,31616
481,30784,2816,896,33600,31680
482,30848,2752,896,33600,31744
483,30912,2688,896,33600,31808
484,30976,2624,896,33600,31872
485,31040,2560,896,33600,31936
486,31104,2496,896,33600,32000
487,31168,2432,896,33600,32064
488,31232,2368,896,33600,32128
489,31296,2304,896,33600,32192
490,31360,2240,896,33600,32256
491,31424,2176,896,33600,32320
492,31488,2112,896,33600,32384
493,31552,2048,896,33600,32448
494,31616,1984,896,33600,32512
495,31680,1920,896,33600,32576
496,31744,1856,896,33600,32640
497,31808,1792,896,33600,32704
498,31872,1728,896,33600,32768
499,31936,1664,896,33600,32832
500,32000,1600,896,33600,32896
501,32064,1536,896,33600,32960
502,32128,1472,896,33600,33024
503,32192,1408,896,33600,33088
504,32256,1344,896,33600,33152
505,32320,1280,896,33600,33216
506,32384,1216,896,33600,33280
507,32448,1152,896,33600,33344
508,32512,1088,896,33600,33408
509,32576,1024,896,33600,33472
510,32640,960,896,33600,33536
511,32704,896,896,33600,33600
512,32768,832,896,33600,33664
513,32832,768,896,33600,33728
514,32896,704,896,33600,33792
515,32960,640,896,33600,33856
516,33024,576,896,33600,33920
517,33088,512,896,33600,33984
518,33152,448,896,33600,34048
519,33216,384,896,33600,34112
520,33280,320,896,33600,34176
521,33344,4864,896,38208,34240
522,33408,4800,896,38208,34304
523,33472,4736,896,38208,34368
524,33536,4672,896,38208,34432
525,33600,4608,896,38208,34496
526,33664,4544,896,38208,34560
527,33728,4480,896,38208,34624
528,33792,4416,896,38208,34688
529,33856,4352,896,38208,34752
530,33920,4288,896,38208,34816
531,33984,4224,896,38208,34880
532,34048,4160,896,38208,34944
533,34112,4096,896,38208,35008
534,34176,4032,896,38208,35072
535,34240,3968,896,38208,35136
536,34304,3904,896,38208,35200
537,34368,3840,896,38208,35264
538,34432,3776,896,38208,35328
539,34496,3712,896,38208,35392
540,34560,3648,896,38208,35456
541,34624,3584,896,38208,35520
542,34688,3520,896,38208,35584
543,34752,3456,896,38208,35648
544,34816,3392,896,38208,35712
545,34880,3328,896,38208,35776
546,34944,3264,896,38208,35840
547,35008,3200,896,38208,35904
548,35072,3136,896,38208,35968
549,35136,3072,896,38208,36032
550,35200,3008,896,38208,36096
551,35264,2944,896,38208,36160
552,35328,2880,896,38208,36224
553,35392,2816,896,38208,36288
554,35456,2752,896,38208,36352
555,35520,2688,896,38208,36416
556,35584,2624,896,38208,36480
557,35648,2560,896,38208,36544
558,35712,2496,896,38208,36608
559,35776,2432,896,38208,36672
560,35840,2368,896,38208,36736
561,35904,2304,896,38208,36800
562,35968,2240,896,38208,36864
563,36032,2176,896,38208,36928
564,36096,2112,896,38208,36992
565,36160,2048,896,38208,37056
566,36224,1984,896,38208,37120
567,36288,1920,896,38208,37184
568,36352,1856,896,38208,37248
569,36416,1792,896,38208,37312
570,36480,1728,896,38208,37376
571,36544,1664,896,38208,37440
572,36608,1600,896,38208,37504
573,36672,1536,896,38208,37568
574,36736,1472,896,38208,37632
575,36800,1408,896,38208,37696
576,36864,1344,896,38208,37760
577,36928,1280,896,38208,37824
578,36992,1216,896,38208,37888
579,37056,1152,896,38208,37952
580,37120,1088,896,38208,38016
581,37184,1024,896,38208,38080
582,37248,960,896,38208,38144
583,37312,896,896,38208,38208
584,37376,832,896,38208,38272
585,37440,768,896,38208,38336
586,37504,704,896,38208,38400
587,37568,640,896,38208,38464
588,37632,576,896,38208,38528
589,37696,512,896,38208,38592
590,37760,448,896,38208,38656
591,37824,384,896,38208,38720
592,37888,320,896,38208,38784
593,37952,5376,896,43328,38848
594,38016,5312,896,43328,38912
595,38080,5248,896,43328,38976
596,38144,5184,896,43328,39040
597,38208,5120,896,43328,39104
598,38272,5056,896,43328,39168
599,38336,4992,896,43328,39232
600,38400,4928,896,43328,39296
601,38464,4864,896,43328,39360
602,38528,4800,896,43328,39424
603,38592,4736,896,43328,39488
604,38656,4672,896,43328,39552
605,38720,4608,896,43328,39616
606,38784,4544,896,43328,39680
607,38848,4480,896,43328,39744
608,38912,4416,896,43328,39808
609,38976,4352,896,43328,39872
610,39040,4288,896,43328,39936
611,39104,4224,896,43328,40000
612,39168,4160,896,43328,40064
613,39232,4096,896,43328,40128
614,39296,4032,896,43328,40192
615,39360,3968,896,43328,40256
616,39424,3904,896,43328,40320
617,39488,3840,896,43328,40384
618,39552,3776,896,43328,40448
619,39616,3712,896,43328,40512
620,39680,3648,896,43328,40576
621,39744,3584,896,43328,40640
622,39808,3520,896,43328,40704
623,39872,3456,896,43328,40768
624,39936,3392,896,43328,40832
625,40000,3328,896,43328,40896
626,40064,3264,896,43328,40960
627,40128,3200,896,43328,41024
628,40192,3136,896,43328,41088
629,40256,3072,896,43328,41152
630,40320,3008,896,43328,41216
631,40384,2944,896,43328,41280
632,40448,2880,896,43328,41344
633,40512,2816,896,43328,41408
634,40576,2752,896,43328,41472
635,40640,2688,896,43328,41536
636,40704,2624,896,43328,41600
637,40768,2560,896,43328,41664
638,40832,2496,896,43328,41728
639,40896,2432,896,43328,41792
640,40960,2368,896,43328,41856
641,41024,2304,896,43328,41920
642,41088,2240,896,43328,41984
643,41152,2176,896,43328,42048
644,41216,2112,896,43328,42112
645,41280,2048,896,43328,42176
646,41344,1984,896,43328,42240
647,41408,1920,896,43328,42304
648,41472,1856,896,43328,42368
649,41536,1792,896,43328,42432
650,41600,1728,896,43328,42496
651,41664,1664,896,43328,42560
652,41728,1600,896,43328,42624
653,41792,1536,896,43328,42688
654,41856,1472,896,43328,42752
655,41920,1408,896,43328,42816
656,41984,1344,896,43328,42880
657,42048,1280,896,43328,42944
658,42112,1216,896,43328,43008
659,42176,1152,896,43328,43072
660,42240,1088,896,43328,43136
661,42304,1024,896,43328,43200
662,42368,960,896,43328,43264
663,42432,896,896,43328,43328
664,42496,832,896,43328,43392
665,42560,768,896,43328,43456
666,42624,704,896,43328,43520
667,42688,640,896,43328,43584
668,42752,576,896,43328,43648
669,42816,512,896,43328,43712
670,42880,448,896,43328,43776
671,42944,384,896,43328,43840
672,43008,320,896,43328,43904
673,43072,5888,896,48960,43968
674,43136,5824,896,48960,44032
675,43200,5760,896,48960,44096
676,43264,5696,896,48960,44160
677,43328,5632,896,48960,44224
678,43392,5568,896,48960,44288
679,43456,5504,896,48960,44352
680,43520,5440,896,48960,44416
681,43584,5376,896,48960,44480
682,43648,5312,896,48960,44544
683,43712,5248,896,48960,44608
684,43776,5184,896,48960,44672
685,43840,5120,896,48960,44736
686,43904,5056,896,48960,44800
687,43968,4992,896,48960,44864
688,44032,4928,896,48960,44928
689,44096,4864,896,48960,44992
690,44160,4800,896,48960,45056
691,44224,4736,896,48960,45120
692,44288,4672,896,48960,45184
693,44352,4608,896,48960,45248
694,44416,4544,896,48960,45312
695,44480,4480,896,48960,45376
696,44544,4416,896,48960,45440
697,44608,4352,896,48960,45504
698,44672,4288,896,48960,45568
699,44736,4224,896,48960,45632
700,44800,4160,896,48960,45696
701,44864,4096,896,48960,45760
702,44928,4032,896,48960,45824
703,44992,3968,896,48960,45888
704,45056,3904,896,48960,45952
705,45120,3840,896,48960,46016
706,45184,3776,896,48960,46080
707,45248,3712,896,48960,46144
708,45312,3648,896,48960,46208
709,45376,3584,896,48960,46272
710,45440,3520,896,48960,46336
711,45504,3456,896,48960,46400
712,45568,3392,896,48960,46464
713,45632,3328,896,48960,46528
714,45696,3264,896,48960,46592
715,45760,3200,896,48960,46656
716,45824,3136,896,48960,46720
717,45888,3072,896,48960,46784
718,45952,3008,896,48960,46848
719,46016,2944,896,48960,46912
720,46080,2880,896,48960,46976
721,46144,2816,896,48960,47040
722,46208,2752,896,48960,47104
723,46272,2688,896,48960,47168
724,46336,2624,896,48960,47232
725,46400,2560,896,48960,47296
726,46464,2496,896,48960,47360
727,46528,2432,896,48960,47424
728,46592,2368,896,48960,47488
729,46656,2304,896,48960,47552
730,46720,2240,896,48960,47616
731,46784,2176,896,48960,47680
732,46848,2112,896,48960,47744
733,46912,2048,896,48960,47808
734,46976,1984,896,48960,47872
735,47040,1920,896,48960,47936
736,47104,1856,896,48960,48000
737,47168,1792,896,48960,48064
738,47232,1728,896,48960,48128
739,47296,1664,896,48960,48192
740,47360,1600,896,48960,48256
741,47424,1536,896,48960,48320
742,47488,1472,896,48960,48384
743,47552,1408,896,48960,48448
744,47616,1344,896,48960,48512
745,47680,1280,896,48960,48576
746,47744,1216,896,48960,48640
747,47808,1152,896,48960,48704
748,47872,1088,896,48960,48768
749,47936,1024,896,48960,48832
750,48000,960,896,48960,48896
751,48064,896,896,48960,48960
752,48128,832,896,48960,49024
753,48192,768,896,48960,49088
754,48256,704,896,48960,49152
755,48320,640,896,48960,49216
756,48384,576,896,48960,49280
757,48448,512,896,48960,49344
758,48512,448,896,48960,49408
759,48576,384,896,48960,49472
760,48640,320,896,48960,49536
761,48704,6656,896,55360,49600
762,48768,6592,896,55360,49664
763,48832,6528,896,55360,49728
764,48896,6464,896,55360,49792
765,48960,6400,896,55360,49856
766,49024,6336,896,55360,49920
767,49088,6272,896,55360,49984
768,49152,6208,896,55360,50048
769,49216,6144,896,55360,50112
770,49280,6080,896,55360,50176
771,49344,6016,896,55360,50240
772,49408,5952,896,55360,50304
773,49472,5888,896,55360,50368
774,49536,5824,896,55360,50432
775,49600,5760,896,55360,50496
776,49664,5696,896,55360,50560
777,49728,5632,896,55360,50624
778,49792,5568,896,55360,50688
779,49856,5504,896,55360,50752
780,49920,5440,896,55360,50816
781,49984,5376,896,55360,50880
782,50048,5312,896,55360,50944
783,50112,5248,896,55360,51008
784,50176,5184,896,55360,51072
785,50240,5120,896,55360,51136
786,50304,5056,896,55360,51200
787,50368,4992,896,55360,51264
788,50432,4928,896,55360,51328
789,50496,4864,896,55360,51392
790,50560,4800,896,55360,51456
791,50624,4736,896,55360,51520
792,50688,4672,896,55360,51584
793,50752,4608,896,55360,51648
794,50816,4544,896,55360,51712
795,50880,4480,896,55360,51776
796,50944,4416,896,55360,51840
797,51008,4352,896,55360,51904
798,51072,4288,896,55360,51968
799,51136,4224,896,55360,52032
800,51200,4160,896,55360,52096
801,51264,4096,896,55360,52160
802,51328,4032,896,55360,52224
803,51392,3968,896,55360,52288
804,51456,3904,896,55360,52352
805,51520,3840,896,55360,52416
806,51584,3776,896,55360,52480
807,51648,3712,896,55360,52544
808,51712,3648,896,55360,52608
809,51776,3584,896,55360,52672
810,51840,3520,896,55360,52736
811,51904,3456,896,55360,52800
812,51968,3392,896,55360,52864
813,52032,3328,896,55360,52928
814,52096,3264,896,55360,52992
815,52160,3200,896,55360,53056
816,52224,3136,896,55360,53120
817,52288,3072,896,55360,53184
818,52352,3008,896,55360,53248
819,52416,2944,896,55360,53312
820,52480,2880,896,55360,53376
821,52544,2816,896,55360,53440
822,52608,2752,896,55360,53504
823,52672,2688,896,55360,53568
824,52736,2624,896,55360,53632
825,52800,2560,896,55360,53696
826,52864,2496,896,55360,53760
827,52928,2432,896,55360,53824
828,52992,2368,896,55360,53888
829,53056,2304,896,55360,53952
830,53120,2240,896,55360,54016
831,53184,2176,896,55360,54080
832,53248,2112,896,55360,54144
833,53312,2048,896,55360,54208
834,53376,1984,896,55360,54272
835,53440,1920,896,55360,54336
836,53504,1856,896,55360,54400
837,53568,1792,896,55360,54464
838,53632,1728,896,55360,54528
839,53696,1664,896,55360,54592
840,53760,1600,896,55360,54656
841,53824,1536,896,55360,54720
842,53888,1472,896,55360,54784
843,53952,1408,896,55360,54848
844,54016,1344,896,55360,54912
845,54080,1280,896,55360,54976
846,54144,1216,896,55360,55040
847,54208,1152,896,55360,55104
848,54272,1088,896,55360,55168
849,54336,1024,896,55360,55232
850,54400,960,896,55360,55296
851,54464,896,896,55360,55360
852,54528,832,896,55360,55424
853,54592,768,896,55360,55488
854,54656,704,896,55360,55552
855,54720,640,896,55360,55616
856,54784,576,896,55360,55680
857,54848,512,896,55360,55744
858,54912,448,896,55360,55808
859,54976,384,896,55360,55872
860,55040,320,896,55360,55936
861,55104,7424,896,62528,56000
862,55168,7360,896,62528,56064
863,55232,7296,896,62528,56128
864,55296,7232,896,62528,56192
865,55360,7168,896,62528,56256
866,55424,7104,896,62528,56320
867,55488,7040,896,62528,56384
868,55552,6976,896,62528,56448
869,55616,6912,896,62528,56512
870,55680,6848,896,62528,56576
871,55744,6784,896,62528,56640
872,55808,6720,896,62528,56704
873,55872,6656,896,62528,56768
874,55936,6592,896,62528,56832
875,56000,6528,896,62528,56896
876,56064,6464,896,62528,56960
877,56128,6400,896,62528,57024
878,56192,6336,896,62528,57088
879,56256,6272,896,62528,57152
880,56320,6208,896,62528,57216
881,56384,6144,896,62528,57280
882,56448,6080,896,62528,57344
883,56512,6016,896,62528,57408
884,56576,5952,896,62528,57472
885,56640,5888,896,62528,57536
886,56704,5824,896,62528,57600
887,56768,5760,896,62528,57664
888,56832,5696,896,62528,57728
889,56896,5632,896,62528,57792
890,56960,5568,896,62528,57856
891,57024,5504,896,62528,57920
892,57088,5440,896,62528,57984
893,57152,5376,896,62528,58048
894,57216,5312,896,62528,58112
895,57280,5248,896,62528,58176
896,57344,5184,896,62528,58240
897,57408,5120,896,62528,58304
898,57472,5056,896,62528,58368
899,57536,4992,896,62528,58432
900,57600,4928,896,62528,58496
901,57664,4864,896,62528,58560
902,57728,4800,896,62528,58624
903,57792,4736,896,62528,58688
904,57856,4672,896,62528,58752
905,57920,4608,896,62528,58816
906,57984,4544,896,62528,58880
907,58048,4480,896,62528,58944
908,58112,4416,896,62528,59008
909,58176,4352,896,62528,59072
910,58240,4288,896,62528,59136
911,58304,4224,896,62528,59200
912,58368,4160,896,62528,59264
913,58432,4096,896,62528,59328
914,58496,4032,896,62528,59392
915,58560,3968,896,62528,59456
916,58624,3904,896,62528,59520
917,58688,3840,896,62528,59584
918,58752,3776,896,62528,59648
919,58816,3712,896,62528,59712
920,58880,3648,896,62528,59776
921,58944,3584,896,62528,59840
922,59008,3520,896,62528,59904
923,59072,3456,896,62528,59968
924,59136,3392,896,62528,60032
925,59200,3328,896,62528,60096
926,59264,3264,896,62528,60160
927,59328,3200,896,62528,60224
928,59392,3136,896,62528,60288
929,59456,3072,896,62528,60352
930,59520,3008,896,62528,60416
931,59584,2944,896,62528,60480
932,59648,2880,896,62528,60544
933,59712,2816,896,62528,60608
934,59776,2752,896,62528,60672
935,59840,2688,896,62528,60736
936,59904,2624,896,62528,60800
937,59968,2560,896,62528,60864
938,60032,2496,896,62528,60928
939,60096,2432,896,62528,60992
940,60160,2368,896,62528,61056
941,60224,2304,896,62528,61120
942,60288,2240,896,62528,61184
943,60352,2176,896,62528,61248
944,60416,2112,896,62528,61312
945,60480,2048,896,62528,61376
946,60544,1984,896,62528,61440
947,60608,1920,896,62528,61504
948,60672,1856,896,62528,61568
949,60736,1792,896,62528,61632
950,60800,1728,896,62528,61696
951,60864,1664,896,62528,61760
952,60928,1600,896,62528,61824
953,60992,1536,896,62528,61888
954,61056,1472,896,62528,61952
955,61120,1408,896,62528,62016
956,61184,1344,896,62528,62080
957,61248,1280,896,62528,62144
958,61312,1216,896,62528,62208
959,61376,1152,896,62528,62272
960,61440,1088,896,62528,62336
961,61504,1024,896,62528,62400
962,61568,960,896,62528,62464
963,61632,896,896,62528,62528
964,61696,832,896,62528,62592
965,61760,768,896,62528,62656
966,61824,704,896,62528,62720
967,61888,640,896,62528,62784
968,61952,576,896,62528,62848
969,62016,512,896,62528,62912
970,62080,448,896,62528,62976
971,62144,384,896,62528,63040
972,62208,320,896,62528,63104
973,62272,8448,896,70720,63168
974,62336,8384,896,70720,63232
975,62400,8320,896,70720,63296
976,62464,8256,896,70720,63360
977,62528,8192,896,70720,63424
978,62592,8128,896,70720,63488
979,62656,8064,896,70720,63552
980,62720,8000,896,70720,63616
981,62784,7936,896,70720,63680
982,62848,7872,896,70720,63744
983,62912,7808,896,70720,63808
984,62976,7744,896,70720,63872
985,63040,7680,896,70720,63936
986,63104,7616,896,70720,64000
987,63168,7552,896,70720,64064
988,63232,7488,896,70720,64128
989,63296,7424,896,70720,64192
990,63360,7360,896,70720,64256
991,63424,7296,896,70720,64320
992,63488,7232,896,70720,64384
993,63552,7168,896,70720,64448
994,63616,7104,896,70720,64512
995,63680,7040,896,70720,64576
996,63744,6976,896,70720,64640
997,63808,6912,896,70720,64704
998,63872,6848,896,70720,64768
999,63936,6784,896,70720,64832
1000,64000,6720,896,70720,64896
1001,64064,6656,896,70720,64960
1002,64128,6592,896,70720,65024
1003,64192,6528,896,70720,65088
1004,64256,6464,896,70720,65152
1005,64320,6400,896,70720,65216
1006,64384,6336,896,70720,65280
1007,64448,6272,896,70720,65344
1008,64512,6208,896,70720,65408
1009,64576,6144,896,70720,65472
1010,64640,6080,896,70720,65536
1011,64704,6016,896,70720,65600
1012,64768,5952,896,70720,65664
1013,64832,5888,896,70720,65728
1014,64896,5824,896,70720,65792
1015,64960,5760,896,70720,65856
1016,65024,5696,896,70720,65920
1017,65088,5632,896,70720,65984
1018,65152,5568,896,70720,66048
1019,65216,5504,896,70720,66112
1020,65280,5440,896,70720,66176
1021,65344,5376,896,70720,66240
1022,65408,5312,896,70720,66304
1023,65472,5248,896,70720,66368
1024,65536,5184,896,70720,66432
1025,65600,5120,896,70720,66496
1026,65664,5056,896,70720,66560
1027,65728,4992,896,70720,66624
1028,65792,4928,896,70720,66688
1029,65856,4864,896,70720,66752
1030,65920,4800,896,70720,66816
1031,65984,4736,896,70720,66880
1032,66048,4672,896,70720,66944
1033,66112,4608,896,70720,67008
1034,66176,4544,896,70720,67072
1035,66240,4480,896,70720,67136
1036,66304,4416,896,70720,67200
1037,66368,4352,896,70720,67264
1038,66432,4288,896,70720,67328
1039,66496,4224,896,70720,67392
1040,66560,4160,896,70720,67456
1041,66624,4096,896,70720,67520
1042,66688,4032,896,70720,67584
1043,66752,3968,896,70720,67648
1044,66816,3904,896,70720,67712
1045,66880,3840,896,70720,67776
1046,66944,3776,896,70720,67840
1047,67008,3712,896,70720,67904
1048,67072,3648,896,70720,67968
1049,67136,3584,896,70720,68032
1050,67200,3520,896,70720,68096
1051,67264,3456,896,70720,68160
1052,67328,3392,896,70720,68224
1053,67392,3328,896,70720,68288
1054,67456,3264,896,70720,68352
1055,67520,3200,896,70720,68416
1056,67584,3136,896,70720,68480
1057,67648,3072,896,70720,68544
1058,67712,3008,896,70720,68608
1059,67776,2944,896,70720,68672
1060,67840,2880,896,70720,68736
1061,67904,2816,896,70720,68800
1062,67968,2752,896,70720,68864
1063,68032,2688,896,70720,68928
1064,68096,2624,896,70720,68992
1065,68160,2560,896,70720,69056
1066,68224,2496,896,70720,69120
1067,68288,2432,896,70720,69184
1068,68352,2368,896,70720,69248
1069,68416,2304,896,70720,69312
1070,68480,2240,896,70720,69376
1071,68544,2176,896,70720,69440
1072,68608,2112,896,70720,69504
1073,68672,2048,896,70720,69568
1074,68736,1984,896,70720,69632
1075,68800,1920,896,70720,69696
1076,68864,1856,896,70720,69760
1077,68928,1792,896,70720,69824
1078,68992,1728,896,70720,69888
1079,69056,1664,896,70720,69952
1080,69120,1600,896,70720,70016
1081,69184,1536,896,70720,70080
1082,69248,1472,896,70720,70144
1083,69312,1408,896,70720,70208
1084,69376,1344,896,70720,70272
1085,69440,1280,896,70720,70336
1086,69504,1216,896,70720,70400
1087,69568,1152,896,70720,70464
1088,69632,1088,896,70720,70528
1089,69696,1024,896,70720,70592
1090,69760,960,896,70720,70656
1091,69824,896,896,70720,70720
1092,69888,832,896,70720,70784
1093,69952,768,896,70720,70848
1094,70016,704,896,70720,70912
1095,70080,640,896,70720,70976
1096,70144,576,896,70720,71040
1097,70208,512,896,70720,71104
1098,70272,448,896,70720,71168
1099,70336,384,896,70720,71232
1100,70400,320,896,70720,71296
1101,70464,9472,896,79936,71360
1102,70528,9408,896,79936,71424
1103,70592,9344,896,79936,71488
1104,70656,9280,896,79936,71552
1105,70720,9216,896,79936,71616
1106,70784,9152,896,79936,71680
1107,70848,9088,896,79936,71744
1108,70912,9024,896,79936,71808
1109,70976,8960,896,79936,71872
1110,71040,8896,896,79936,71936
1111,71104,8832,896,79936,72000
1112,71168,8768,896,79936,72064
1113,71232,8704,896,79936,72128
1114,71296,8640,896,79936,72192
1115,71360,8576,896,79936,72256
1116,71424,8512,896,79936,72320
1117,71488,8448,896,79936,72384
1118,71552,8384,896,79936,72448
1119,71616,8320,896,79936,72512
1120,71680,8256,896,79936,72576
1121,71744,8192,896,79936,72640
1122,71808,8128,896,79936,72704
1123,71872,8064,896,79936,72768
1124,71936,8000,896,79936,72832
1125,72000,7936,896,79936,72896
1126,72064,7872,896,79936,72960
1127,72128,7808,896,79936,73024
1128,72192,7744,896,79936,73088
1129,72256,7680,896,79936,73152
1130,72320,7616,896,79936,73216
1131,72384,7552,896,79936,73280
1132,72448,7488,896,79936,73344
1133,72512,7424,896,79936,73408
1134,72576,7360,896,79936,73472
1135,72640,7296,896,79936,73536
1136,72704,7232,896,79936,73600
1137,72768,7168,896,79936,73664
1138,72832,7104,896,79936,73728
1139,72896,7040,896,79936,73792
1140,72960,6976,896,79936,73856
1141,73024,6912,896,79936,73920
1142,73088,6848,896,79936,73984
1143,73152,6784,896,79936,74048
1144,73216,6720,896,79936,74112
1145,73280,6656,896,79936,74176
1146,73344,6592,896,79936,74240
1147,73408,6528,896,79936,74304
1148,73472,6464,896,79936,74368
1149,73536,6400,896,79936,74432
1150,73600,6336,896,79936,74496
1151,73664,6272,896,79936,74560
1152,73728,6208,896,79936,74624
1153,73792,6144,896,79936,74688
1154,73856,6080,896,79936,74752
1155,73920,6016,896,79936,74816
1156,73984,5952,896,79936,74880
1157,74048,5888,896,79936,74944
1158,74112,5824,896,79936,75008
1159,74176,5760,896,79936,75072
1160,74240,5696,896,79936,75136
1161,74304,5632,896,79936,75200
1162,74368,5568,896,79936,75264
1163,74432,5504,896,79936,75328
1164,74496,5440,896,79936,75392
1165,74560,5376,896,79936,75456
1166,74624,5312,896,79936,75520
1167,74688,5248,896,79936,75584
1168,74752,5184,896,79936,75648
1169,74816,5120,896,79936,75712
1170,74880,5056,896,79936,75776
1171,74944,4992,896,79936,75840
1172,75008,4928,896,79936,75904
1173,75072,4864,896,79936,75968
1174,75136,4800,896,79936,76032
1175,75200,4736,896,79936,76096
1176,75264,4672,896,79936,76160
1177,75328,4608,896,79936,76224
1178,75392,4544,896,79936,76288
1179,75456,4480,896,79936,76352
1180,75520,4416,896,79936,76416
1181,75584,4352,896,79936,76480
1182,75648,4288,896,79936,76544
1183,75712,4224,896,79936,76608
1184,75776,4160,896,79936,76672
1185,75840,4096,896,79936,76736
1186,75904,4032,896,79936,76800
1187,75968,3968,896,79936,76864
1188,76032,3904,896,79936,76928
1189,76096,3840,896,79936,76992
1190,76160,3776,896,79936,77056
1191,76224,3712,896,79936,77120
1192,76288,3648,896,79936,77184
1193,76352,3584,896,79936,77248
1194,76416,3520,896,79936,77312
1195,76480,3456,896,79936,77376
1196,76544,3392,896,79936,77440
1197,76608,3328,896,79936,77504
1198,76672,3264,896,79936,77568
1199,76736,3200,896,79936,77632
1200,76800,3136,896,79936,77696
1201,76864,3072,896,79936,77760
1202,76928,3008,896,79936,77824
1203,76992,2944,896,79936,77888
1204,77056,2880,896,79936,77952
1205,77120,2816,896,79936,78016
1206,77184,2752,896,79936,78080
1207,77248,2688,896,79936,78144
1208,77312,2624,896,79936,78208
1209,77376,2560,896,79936,78272
1210,77440,2496,896,79936,78336
1211,77504,2432,896,79936,78400
1212,77568,2368,896,79936,78464
1213,77632,2304,896,79936,78528
1214,77696,2240,896,79936,78592
1215,77760,2176,896,79936,78656
1216,77824,2112,896,79936,78720
1217,77888,2048,896,79936,78784
1218,77952,1984,896,79936,78848
1219,78016,1920,896,79936,78912
1220,78080,1856,896,79936,78976
1221,78144,1792,896,79936,79040
1222,78208,1728,896,79936,79104
1223,78272,1664,896,79936,79168
1224,78336,1600,896,79936,79232
1225,78400,1536,896,79936,79296
1226,78464,1472,896,79936,79360
1227,78528,1408,896,79936,79424
1228,78592,1344,896,79936,79488
1229,78656,1280,896,79936,79552
1230,78720,1216,896,79936,79616
1231,78784,1152,896,79936,79680
1232,78848,1088,896,79936,79744
1233,78912,1024,896,79936,79808
1234,78976,960,896,79936,79872
1235,79040,896,896,79936,79936
1236,79104,832,896,79936,80000
1237,79168,768,896,79936,80064
1238,79232,704,896,79936,80128
1239,79296,640,896,79936,80192
1240,79360,576,896,79936,80256
1241,79424,512,896,79936,80320
1242,79488,448,896,79936,80384
1243,79552,384,896,79936,80448
1244,79616,320,896,79936,80512
1245,79680,10496,896,90176,80576
1246,79744,10432,896,90176,80640
1247,79808,10368,896,90176,80704
1248,79872,10304,896,90176,80768
1249,79936,10240,896,90176,80832
1250,80000,10176,896,90176,80896
1251,80064,10112,896,90176,80960
1252,80128,10048,896,90176,81024
1253,80192,9984,896,90176,81088
1254,80256,9920,896,90176,81152
1255,80320,9856,896,90176,81216
1256,80384,9792,896,90176,81280
1257,80448,9728,896,90176,81344
1258,80512,9664,896,90176,81408
1259,80576,9600,896,90176,81472
1260,80640,9536,896,90176,81536
1261,80704,9472,896,90176,81600
1262,80768,9408,896,90176,81664
1263,80832,9344,896,90176,81728
1264,80896,9280,896,90176,81792
1265,80960,9216,896,90176,81856
1266,81024,9152,896,90176,81920
1267,81088,9088,896,90176,81984
1268,81152,9024,896,90176,82048
1269,81216,8960,896,90176,82112
1270,81280,8896,896,90176,82176
1271,81344,8832,896,90176,82240
1272,81408,8768,896,90176,82304
1273,81472,8704,896,90176,82368
1274,81536,8640,896,90176,82432
1275,81600,8576,896,90176,82496
1276,81664,8512,896,90176,82560
1277,81728,8448,896,90176,82624
1278,81792,8384,896,90176,82688
1279,81856,8320,896,90176,82752
1280,81920,8256,896,90176,82816
1281,81984,8192,896,90176,82880
1282,82048,8128,896,90176,82944
1283,82112,8064,896,90176,83008
1284,82176,8000,896,90176,83072
1285,82240,7936,896,90176,83136
1286,82304,7872,896,90176,83200
1287,82368,7808,896,90176,83264
1288,82432,7744,896,90176,83328
1289,82496,7680,896,90176,83392
1290,82560,7616,896,90176,83456
1291,82624,7552,896,90176,83520
1292,82688,7488,896,90176,83584
1293,82752,7424,896,90176,83648
1294,82816,7360,896,90176,83712
1295,82880,7296,896,90176,83776
1296,82944,7232,896,90176,83840
1297,83008,7168,896,90176,83904
1298,83072,7104,896,90176,83968
1299,83136,7040,896,90176,84032
1300,83200,6976,896,90176,84096
1301,83264,6912,896,90176,84160
1302,83328,6848,896,90176,84224
1303,83392,6784,896,90176,84288
1304,83456,6720,896,90176,84352
1305,83520,6656,896,90176,84416
1306,83584,6592,896,90176,84480
1307,83648,6528,896,90176,84544
1308,83712,6464,896,90176,84608
1309,83776,6400,896,90176,84672
1310,83840,6336,896,90176,84736
1311,83904,6272,896,90176,84800
1312,83968,6208,896,90176,84864
1313,84032,6144,896,90176,84928
1314,84096,6080,896,90176,84992
1315,84160,6016,896,90176,85056
1316,84224,5952,896,90176,85120
1317,84288,5888,896,90176,85184
1318,84352,5824,896,90176,85248
1319,84416,5760,896,90176,85312
1320,84480,5696,896,90176,85376
1321,84544,5632,896,90176,85440
1322,84608,5568,896,90176,85504
1323,84672,5504,896,90176,85568
1324,84736,5440,896,90176,85632
1325,84800,5376,896,90176,85696
1326,84864,5312,896,90176,85760
1327,84928,5248,896,90176,85824
1328,84992,5184,896,90176,85888
1329,85056,5120,896,90176,85952
1330,85120,5056,896,90176,86016
1331,85184,4992,896,90176,86080
1332,85248,4928,896,90176,86144
1333,85312,4864,896,90176,86208
1334,85376,4800,896,90176,86272
1335,85440,4736,896,90176,86336
1336,85504,4672,896,90176,86400
1337,85568,4608,896,90176,86464
1338,85632,4544,896,90176,86528
1339,85696,4480,896,90176,86592
1340,85760,4416,896,90176,86656
1341,85824,4352,896,90176,86720
1342,85888,4288,896,90176,86784
1343,85952,4224,896,90176,86848
1344,86016,4160,896,90176,86912
1345,86080,4096,896,90176,86976
1346,86144,4032,896,90176,87040
1347,86208,3968,896,90176,87104
1348,86272,3904,896,90176,87168
1349,86336,3840,896,90176,87232
1350,86400,3776,896,90176,87296
1351,86464,3712,896,90176,87360
1352,86528,3648,896,90176,87424
1353,86592,3584,896,90176,87488
1354,86656,3520,896,90176,87552
1355,86720,3456,896,90176,87616
1356,86784,3392,896,90176,87680
1357,86848,3328,896,90176,87744
1358,86912,3264,896,90176,87808
1359,86976,3200,896,90176,87872
1360,87040,3136,896,90176,87936
1361,87104,3072,896,90176,88000
1362,87168,3008,896,90176,88064
1363,87232,2944,896,90176,88128
1364,87296,2880,896,90176,88192
1365,87360,2816,896,90176,88256
1366,87424,2752,896,90176,88320
1367,87488,2688,896,90176,88384
1368,87552,2624,896,90176,88448
1369,87616,2560,896,90176,88512
1370,87680,2496,896,90176,88576
1371,87744,2432,896,90176,88640
1372,87808,2368,896,90176,88704
1373,87872,2304,896,90176,88768
1374,87936,2240,896,90176,88832
1375,88000,2176,896,90176,88896
1376,88064,2112,896,90176,88960
1377,88128,2048,896,90176,89024
1378,88192,1984,896,90176,89088
1379,88256,1920,896,90176,89152
1380,88320,1856,896,90176,89216
1381,88384,1792,896,90176,89280
1382,88448,1728,896,90176,89344
1383,88512,1664,896,90176,89408
1384,88576,1600,896,90176,89472
1385,88640,1536,896,90176,89536
1386,88704,1472,896,90176,89600
1387,88768,1408,896,90176,89664
1388,88832,1344,896,90176,89728
1389,88896,1280,896,90176,89792
1390,88960,1216,896,90176,89856
1391,89024,1152,896,90176,89920
1392,89088,1088,896,90176,89984
1393,89152,1024,896,90176,90048
1394,89216,960,896,90176,90112
1395,89280,896,896,90176,90176
1396,89344,832,896,90176,90240
1397,89408,768,896,90176,90304
1398,89472,704,896,90176,90368
1399,89536,640,896,90176,90432
1400,89600,576,896,90176,90496
1401,89664,512,896,90176,90560
1402,89728,448,896,90176,90624
1403,89792,384,896,90176,90688
1404,89856,320,896,90176,90752
1405,89920,11776,896,101696,90816
1406,89984,11712,896,101696,90880
1407,90048,11648,896,101696,90944
1408,90112,11584,896,101696,91008
1409,90176,11520,896,101696,91072
1410,90240,11456,896,101696,91136
1411,90304,11392,896,101696,91200
1412,90368,11328,896,101696,91264
1413,90432,11264,896,101696,91328
1414,90496,11200,896,101696,91392
1415,90560,11136,896,101696,91456
1416,90624,11072,896,101696,91520
1417,90688,11008,896,101696,91584
1418,90752,10944,896,101696,91648
1419,90816,10880,896,101696,91712
1420,90880,10816,896,101696,91776
1421,90944,10752,896,101696,91840
1422,91008,10688,896,101696,91904
1423,91072,10624,896,101696,91968
1424,91136,10560,896,101696,92032
1425,91200,10496,896,101696,92096
1426,91264,10432,896,101696,92160
1427,91328,10368,896,101696,92224
1428,91392,10304,896,101696,92288
1429,91456,10240,896,101696,92352
1430,91520,10176,896,101696,92416
1431,91584,10112,896,101696,92480
1432,91648,10048,896,101696,92544
1433,91712,9984,896,101696,92608
1434,91776,9920,896,101696,92672
1435,91840,9856,896,101696,92736
1436,91904,9792,896,101696,92800
1437,91968,9728,896,101696,92864
1438,92032,9664,896,101696,92928
1439,92096,9600,896,101696,92992
1440,92160,9536,896,101696,93056
1441,92224,9472,896,101696,93120
1442,92288,9408,896,101696,93184
1443,92352,9344,896,101696,93248
1444,92416,9280,896,101696,93312
1445,92480,9216,896,101696,93376
1446,92544,9152,896,101696,93440
1447,92608,9088,896,101696,93504
1448,92672,9024,896,101696,93568
1449,92736,8960,896,101696,93632
1450,92800,8896,896,101696,93696
1451,92864,8832,896,101696,93760
1452,92928,8768,896,101696,93824
1453,92992,8704,896,101696,93888
1454,93056,8640,896,101696,93952
1455,93120,8576,896,101696,94016
1456,93184,8512,896,101696,94080
1457,93248,8448,896,101696,94144
1458,93312,8384,896,101696,94208
1459,93376,8320,896,101696,94272
1460,93440,8256,896,101696,94336
1461,93504,8192,896,101696,94400
1462,93568,8128,896,101696,94464
1463,93632,8064,896,101696,94528
1464,93696,8000,896,101696,94592
1465,93760,7936,896,101696,94656
1466,93824,7872,896,101696,94720
1467,93888,7808,896,101696,94784
1468,93952,7744,896,101696,94848
1469,94016,7680,896,101696,94912
1470,94080,7616,896,101696,94976
1471,94144,7552,896,101696,95040
1472,94208,7488,896,101696,95104
1473,94272,7424,896,101696,95168
1474,94336,7360,896,101696,95232
1475,94400,7296,896,101696,95296
1476,94464,7232,896,101696,95360
1477,94528,7168,896,101696,95424
1478,94592,7104,896,101696,95488
1479,94656,7040,896,101696,95552
1480,94720,6976,896,101696,95616
1481,94784,6912,896,101696,95680
1482,94848,6848,896,101696,95744
1483,94912,6784,896,101696,95808
1484,94976,6720,896,101696,95872
1485,95040,6656,896,101696,95936
1486,95104,6592,896,101696,96000
1487,95168,6528,896,101696,96064
1488,95232,6464,896,101696,96128
1489,95296,6400,896,101696,96192
1490,95360,6336,896,101696,96256
1491,95424,6272,896,101696,96320
1492,95488,6208,896,101696,96384
1493,95552,6144,896,101696,96448
1494,95616,6080,896,101696,96512
1495,95680,6016,896,101696,96576
1496,95744,5952,896,101696,96640
1497,95808,5888,896,101696,96704
1498,95872,5824,896,101696,96768
1499,95936,5760,896,101696,96832
1500,96000,5696,896,101696,96896
1501,96064,5632,896,101696,96960
1502,96128,5568,896,101696,97024
1503,96192,5504,896,101696,97088
1504,96256,5440,896,101696,97152
1505,96320,5376,896,101696,97216
1506,96384,5312,896,101696,97280
1507,96448,5248,896,101696,97344
1508,96512,5184,896,101696,97408
1509,96576,5120,896,101696,97472
1510,96640,5056,896,101696,97536
1511,96704,4992,896,101696,97600
1512,96768,4928,896,101696,97664
1513,96832,4864,896,101696,97728
1514,96896,4800,896,101696,97792
1515,96960,4736,896,101696,97856
1516,97024,4672,896,101696,97920
1517,97088,4608,896,101696,97984
1518,97152,4544,896,101696,98048
1519,97216,4480,896,101696,98112
1520,97280,4416,896,101696,98176
1521,97344,4352,896,101696,98240
1522,97408,4288,896,101696,98304
1523,97472,4224,896,101696,98368
1524,97536,4160,896,101696,98432
1525,97600,4096,896,101696,98496
1526,97664,4032,896,101696,98560
1527,97728,3968,896,101696,98624
1528,97792,3904,896,101696,98688
1529,97856,3840,896,101696,98752
1530,97920,3776,896,101696,98816
1531,97984,3712,896,101696,98880
1532,98048,3648,896,101696,98944
1533,98112,3584,896,101696,99008
1534,98176,3520,896,101696,99072
1535,98240,3456,896,101696,99136
1536,98304,3392,896,101696,99200
1537,98368,3328,896,101696,99264
1538,98432,3264,896,101696,99328
1539,98496,3200,896,101696,99392
1540,98560,3136,896,101696,99456
1541,98624,3072,896,101696,99520
1542,98688,3008,896,101696,99584
1543,98752,2944,896,101696,99648
1544,98816,2880,896,101696,99712
1545,98880,2816,896,101696,99776
1546,98944,2752,896,101696,99840
1547,99008,2688,896,101696,99904
1548,99072,2624,896,101696,99968
1549,99136,2560,896,101696,100032
1550,99200,2496,896,101696,100096
1551,99264,2432,896,101696,100160
1552,99328,2368,896,101696,100224
1553,99392,2304,896,101696,100288
1554,99456,2240,896,101696,100352
1555,99520,2176,896,101696,100416
1556,99584,2112,896,101696,100480
1557,99648,2048,896,101696,100544
1558,99712,1984,896,101696,100608
1559,99776,1920,896,101696,100672
1560,99840,1856,896,101696,100736
1561,99904,1792,896,101696,100800
1562,99968,1728,896,101696,100864
1563,100032,1664,896,101696,100928
1564,100096,1600,896,101696,100992
1565,100160,1536,896,101696,101056
1566,100224,1472,896,101696,101120
1567,100288,1408,896,101696,101184
1568,100352,1344,896,101696,101248
1569,100416,1280,896,101696,101312
1570,100480,1216,896,101696,101376
1571,100544,1152,896,101696,101440
1572,100608,1088,896,101696,101504
1573,100672,1024,896,101696,101568
1574,100736,960,896,101696,101632
1575,100800,896,896,101696,101696
1576,100864,832,896,101696,101760
1577,100928,768,896,101696,101824
1578,100992,704,896,101696,101888
1579,101056,640,896,101696,101952
1580,101120,576,896,101696,102016
1581,101184,512,896,101696,102080
1582,101248,448,896,101696,102144
1583,101312,384,896,101696,102208
1584,101376,320,896,101696,102272
1585,101440,13312,896,114752,102336
1586,101504,13248,896,114752,102400
1587,101568,13184,896,114752,102464
1588,101632,13120,896,114752,102528
1589,101696,13056,896,114752,102592
1590,101760,12992,896,114752,102656
1591,101824,12928,896,114752,102720
1592,101888,12864,896,114752,102784
1593,101952,12800,896,114752,102848
1594,102016,12736,896,114752,102912
1595,102080,12672,896,114752,102976
1596,102144,12608,896,114752,103040
1597,102208,12544,896,114752,103104
1598,102272,12480,896,114752,103168
1599,102336,12416,896,114752,103232
1600,102400,12352,896,114752,103296
1601,102464,12288,896,114752,103360
1602,102528,12224,896,114752,103424
1603,102592,12160,896,114752,103488
1604,102656,12096,896,114752,103552
1605,102720,12032,896,114752,103616
1606,102784,11968,896,114752,103680
1607,102848,11904,896,114752,103744
1608,102912,11840,896,114752,103808
1609,102976,11776,896,114752,103872
1610,103040,11712,896,114752,103936
1611,103104,11648,896,114752,104000
1612,103168,11584,896,114752,104064
1613,103232,11520,896,114752,104128
1614,103296,11456,896,114752,104192
1615,103360,11392,896,114752,104256
1616,103424,11328,896,114752,104320
1617,103488,11264,896,114752,104384
1618,103552,11200,896,114752,104448
1619,103616,11136,896,114752,104512
1620,103680,11072,896,114752,104576
1621,103744,11008,896,114752,104640
1622,103808,10944,896,114752,104704
1623,103872,10880,896,114752,104768
1624,103936,10816,896,114752,104832
1625,104000,10752,896,114752,104896
1626,104064,10688,896,114752,104960
1627,104128,10624,896,114752,105024
1628,104192,10560,896,114752,105088
1629,104256,10496,896,114752,105152
1630,104320,10432,896,114752,105216
1631,104384,10368,896,114752,105280
1632,104448,10304,896,114752,105344
1633,104512,10240,896,114752,105408
1634,104576,10176,896,114752,105472
1635,104640,10112,896,114752,105536
1636,104704,10048,896,114752,105600
1637,104768,9984,896,114752,105664
1638,104832,9920,896,114752,105728
1639,104896,9856,896,114752,105792
1640,104960,9792,896,114752,105856
1641,105024,9728,896,114752,105920
1642,105088,9664,896,114752,105984
1643,105152,9600,896,114752,106048
1644,105216,9536,896,114752,106112
1645,105280,9472,896,114752,106176
1646,105344,9408,896,114752,106240
1647,105408,9344,896,114752,106304
1648,105472,9280,896,114752,106368
1649,105536,9216,896,114752,106432
1650,105600,9152,896,114752,106496
1651,105664,9088,896,114752,106560
1652,105728,9024,896,114752,106624
1653,105792,8960,896,114752,106688
1654,105856,8896,896,114752,106752
1655,105920,8832,896,114752,106816
1656,105984,8768,896,114752,106880
1657,106048,8704,896,114752,106944
1658,106112,8640,896,114752,107008
1659,106176,8576,896,114752,107072
1660,106240,8512,896,114752,107136
1661,106304,8448,896,114752,107200
1662,106368,8384,896,114752,107264
1663,106432,8320,896,114752,107328
1664,106496,8256,896,114752,107392
1665,106560,8192,896,114752,107456
1666,106624,8128,896,114752,107520
1667,106688,8064,896,114752,107584
1668,106752,8000,896,114752,107648
1669,106816,7936,896,114752,107712
1670,106880,7872,896,114752,107776
1671,106944,7808,896,114752,107840
1672,107008,7744,896,114752,107904
1673,107072,7680,896,114752,107968
1674,107136,7616,896,114752,108032
1675,107200,7552,896,114752,108096
1676,107264,7488,896,114752,108160
1677,107328,7424,896,114752,108224
1678,107392,7360,896,114752,108288
1679,107456,7296,896,114752,108352
1680,107520,7232,896,114752,108416
1681,107584,7168,896,114752,108480
1682,107648,7104,896,114752,108544
1683,107712,7040,896,114752,108608
1684,107776,6976,896,114752,108672
1685,107840,6912,896,114752,108736
1686,107904,6848,896,114752,108800
1687,107968,6784,896,114752,108864
1688,108032,6720,896,114752,108928
1689,108096,6656,896,114752,108992
1690,108160,6592,896,114752,109056
1691,108224,6528,896,114752,109120
1692,108288,6464,896,114752,109184
1693,108352,6400,896,114752,109248
1694,108416,6336,896,114752,109312
1695,108480,6272,896,114752,109376
1696,108544,6208,896,114752,109440
1697,108608,6144,896,114752,109504
1698,108672,6080,896,114752,109568
1699,108736,6016,896,114752,109632
1700,108800,5952,896,114752,109696
1701,108864,5888,896,114752,109760
1702,108928,5824,896,114752,109824
1703,108992,5760,896,114752,109888
1704,109056,5696,896,114752,109952
1705,109120,5632,896,114752,110016
1706,109184,5568,896,114752,110080
1707,109248,5504,896,114752,110144
1708,109312,5440,896,114752,110208
1709,109376,5376,896,114752,110272
1710,109440,5312,896,114752,110336
1711,109504,5248,896,114752,110400
1712,109568,5184,896,114752,110464
1713,109632,5120,896,114752,110528
1714,109696,5056,896,114752,110592
1715,109760,4992,896,114752,110656
1716,109824,4928,896,114752,110720
1717,109888,4864,896,114752,110784
1718,109952,4800,896,114752,110848
1719,110016,4736,896,114752,110912
1720,110080,4672,896,114752,110976
1721,110144,4608,896,114752,111040
1722,110208,4544,896,114752,111104
1723,110272,4480,896,114752,111168
1724,110336,4416,896,114752,111232
1725,110400,4352,896,114752,111296
1726,110464,4288,896,114752,111360
1727,110528,4224,896,114752,111424
1728,110592,4160,896,114752,111488
1729,110656,4096,896,114752,111552
1730,110720,4032,896,114752,111616
1731,110784,3968,896,114752,111680
1732,110848,3904,896,114752,111744
1733,110912,3840,896,114752,111808
1734,110976,3776,896,114752,111872
1735,111040,3712,896,114752,111936
1736,111104,3648,896,114752,112000
1737,111168,3584,896,114752,112064
1738,111232,3520,896,114752,112128
1739,111296,3456,896,114752,112192
1740,111360,3392,896,114752,112256
1741,111424,3328,896,114752,112320
1742,111488,3264,896,114752,112384
1743,111552,3200,896,114752,112448
1744,111616,3136,896,114752,112512
1745,111680,3072,896,114752,112576
1746,111744,3008,896,114752,112640
1747,111808,2944,896,114752,112704
1748,111872,2880,896,114752,112768
1749,111936,2816,896,114752,112832
1750,112000,2752,896,114752,112896
1751,112064,2688,896,114752,112960
1752,112128,2624,896,114752,113024
1753,112192,2560,896,114752,113088
1754,112256,2496,896,114752,113152
1755,112320,2432,896,114752,113216
1756,112384,2368,896,114752,113280
1757,112448,2304,896,114752,113344
1758,112512,2240,896,114752,113408
1759,112576,2176,896,114752,113472
1760,112640,2112,896,114752,113536
1761,112704,2048,896,114752,113600
1762,112768,1984,896,114752,113664
1763,112832,1920,896,114752,113728
1764,112896,1856,896,114752,113792
1765,112960,1792,896,114752,113856
1766,113024,1728,896,114752,113920
1767,113088,1664,896,114752,113984
1768,113152,1600,896,114752,114048
1769,113216,1536,896,114752,114112
1770,113280,1472,896,114752,114176
1771,113344,1408,896,114752,114240
1772,113408,1344,896,114752,114304
1773,113472,1280,896,114752,114368
1774,113536,1216,896,114752,114432
1775,113600,1152,896,114752,114496
1776,113664,1088,896,114752,114560
1777,113728,1024,896,114752,114624
1778,113792,960,896,114752,114688
1779,113856,896,896,114752,114752
1780,113920,832,896,114752,114816
1781,113984,768,896,114752,114880
1782,114048,704,896,114752,114944
1783,114112,640,896,114752,115008
1784,114176,576,896,114752,115072
1785,114240,512,896,114752,115136
1786,114304,448,896,114752,115200
1787,114368,384,896,114752,115264
1788,114432,320,896,114752,115328
1789,114496,14848,896,129344,115392
1790,114560,14784,896,129344,115456
1791,114624,14720,896,129344,115520
1792,114688,14656,896,129344,115584
1793,114752,14592,896,129344,115648
1794,114816,14528,896,129344,115712
1795,114880,14464,896,129344,115776
1796,114944,14400,896,129344,115840
1797,115008,14336,896,129344,115904
1798,115072,14272,896,129344,115968
1799,115136,14208,896,129344,116032
1800,115200,14144,896,129344,116096
1801,115264,14080,896,129344,116160
1802,115328,14016,896,129344,116224
1803,115392,13952,896,129344,116288
1804,115456,13888,896,129344,116352
1805,115520,13824,896,129344,116416
1806,115584,13760,896,129344,116480
1807,115648,13696,896,129344,116544
1808,115712,13632,896,129344,116608
1809,115776,13568,896,129344,116672
1810,115840,13504,896,129344,116736
1811,115904,13440,896,129344,116800
1812,115968,13376,896,129344,116864
1813,116032,13312,896,129344,116928
1814,116096,13248,896,129344,116992
1815,116160,13184,896,129344,117056
1816,116224,13120,896,129344,117120
1817,116288,13056,896,129344,117184
1818,116352,12992,896,129344,117248
1819,116416,12928,896,129344,117312
1820,116480,12864,896,129344,117376
1821,116544,12800,896,129344,117440
1822,116608,12736,896,129344,117504
1823,116672,12672,896,129344,117568
1824,116736,12608,896,129344,117632
1825,116800,12544,896,129344,117696
1826,116864,12480,896,129344,117760
1827,116928,12416,896,129344,117824
1828,116992,12352,896,129344,117888
1829,117056,12288,896,129344,117952
1830,117120,12224,896,129344,118016
1831,117184,12160,896,129344,118080
1832,117248,12096,896,129344,118144
1833,117312,12032,896,129344,118208
1834,117376,11968,896,129344,118272
1835,117440,11904,896,129344,118336
1836,117504,11840,896,129344,118400
1837,117568,11776,896,129344,118464
1838,117632,11712,896,129344,118528
1839,117696,11648,896,129344,118592
1840,117760,11584,896,129344,118656
1841,117824,11520,896,129344,118720
1842,117888,11456,896,129344,118784
1843,117952,11392,896,129344,118848
1844,118016,11328,896,129344,118912
1845,118080,11264,896,129344,118976
1846,118144,11200,896,129344,119040
1847,118208,11136,896,129344,119104
1848,118272,11072,896,129344,119168
1849,118336,11008,896,129344,119232
1850,118400,10944,896,129344,119296
1851,118464,10880,896,129344,119360
1852,118528,10816,896,129344,119424
1853,118592,10752,896,129344,119488
1854,118656,10688,896,129344,119552
1855,118720,10624,896,129344,119616
1856,118784,10560,896,129344,119680
1857,118848,10496,896,129344,119744
1858,118912,10432,896,129344,119808
1859,118976,10368,896,129344,119872
1860,119040,10304,896,129344,119936
1861,119104,10240,896,129344,120000
1862,119168,10176,896,129344,120064
1863,119232,10112,896,129344,120128
1864,119296,10048,896,129344,120192
1865,119360,9984,896,129344,120256
1866,119424,9920,896,129344,120320
1867,119488,9856,896,129344,120384
1868,119552,9792,896,129344,120448
1869,119616,9728,896,129344,120512
1870,119680,9664,896,129344,120576
1871,119744,9600,896,129344,120640
1872,119808,9536,896,129344,120704
1873,119872,9472,896,129344,120768
1874,119936,9408,896,129344,120832
1875,120000,9344,896,129344,120896
1876,120064,9280,896,129344,120960
1877,120128,9216,896,129344,121024
1878,120192,9152,896,129344,121088
1879,120256,9088,896,129344,121152
1880,120320,9024,896,129344,121216
1881,120384,8960,896,129344,121280
1882,120448,8896,896,129344,121344
1883,120512,8832,896,129344,121408
1884,120576,8768,896,129344,121472
1885,120640,8704,896,129344,121536
1886,120704,8640,896,129344,121600
1887,120768,8576,896,129344,121664
1888,120832,8512,896,129344,121728
1889,120896,8448,896,129344,121792
1890,120960,8384,896,129344,121856
1891,121024,8320,896,129344,121920
1892,121088,8256,896,129344,121984
1893,121152,8192,896,129344,122048
1894,121216,8128,896,129344,122112
1895,121280,8064,896,129344,122176
1896,121344,8000,896,129344,122240
1897,121408,7936,896,129344,122304
1898,121472,7872,896,129344,122368
1899,121536,7808,896,129344,122432
1900,121600,7744,896,129344,122496
1901,121664,7680,896,129344,122560
1902,121728,7616,896,129344,122624
1903,121792,7552,896,129344,122688
1904,121856,7488,896,129344,122752
1905,121920,7424,896,129344,122816
1906,121984,7360,896,129344,122880
1907,122048,7296,896,129344,122944
1908,122112,7232,896,129344,123008
1909,122176,7168,896,129344,123072
1910,122240,7104,896,129344,123136
1911,122304,7040,896,129344,123200
1912,122368,6976,896,129344,123264
1913,122432,6912,896,129344,123328
1914,122496,6848,896,129344,123392
1915,122560,6784,896,129344,123456
1916,122624,6720,896,129344,123520
1917,122688,6656,896,129344,123584
1918,122752,6592,896,129344,123648
1919,122816,6528,896,129344,123712
1920,122880,6464,896,129344,123776
1921,122944,6400,896,129344,123840
1922,123008,6336,896,129344,123904
1923,123072,6272,896,129344,123968
1924,123136,6208,896,129344,124032
1925,123200,6144,896,129344,124096
1926,123264,6080,896,129344,124160
1927,123328,6016,896,129344,124224
1928,123392,5952,896,129344,124288
1929,123456,5888,896,129344,124352
1930,123520,5824,896,129344,124416
1931,123584,5760,896,129344,124480
1932,123648,5696,896,129344,124544
1933,123712,5632,896,129344,124608
1934,123776,5568,896,129344,124672
1935,123840,5504,896,129344,124736
1936,123904,5440,896,129344,124800
1937,123968,5376,896,129344,124864
1938,124032,5312,896,129344,124928
1939,124096,5248,896,129344,124992
1940,124160,5184,896,129344,125056
1941,124224,5120,896,129344,125120
1942,124288,5056,896,129344,125184
1943,124352,4992,896,129344,125248
1944,124416,4928,896,129344,125312
1945,124480,4864,896,129344,125376
1946,124544,4800,896,129344,125440
1947,124608,4736,896,129344,125504
1948,124672,4672,896,129344,125568
1949,124736,4608,896,129344,125632
1950,124800,4544,896,129344,125696
1951,124864,4480,896,129344,125760
1952,124928,4416,896,129344,125824
1953,124992,4352,896,129344,125888
1954,125056,4288,896,129344,125952
1955,125120,4224,896,129344,126016
1956,125184,4160,896,129344,126080
1957,125248,4096,896,129344,126144
1958,125312,4032,896,129344,126208
1959,125376,3968,896,129344,126272
1960,125440,3904,896,129344,126336
1961,125504,3840,896,129344,126400
1962,125568,3776,896,129344,126464
1963,125632,3712,896,129344,126528
1964,125696,3648,896,129344,126592
1965,125760,3584,896,129344,126656
1966,125824,3520,896,129344,126720
1967,125888,3456,896,129344,126784
1968,125952,3392,896,129344,126848
1969,126016,3328,896,129344,126912
1970,126080,3264,896,129344,126976
1971,126144,3200,896,129344,127040
1972,126208,3136,896,129344,127104
1973,126272,3072,896,129344,127168
1974,126336,3008,896,129344,127232
1975,126400,2944,896,129344,127296
1976,126464,2880,896,129344,127360
1977,126528,2816,896,129344,127424
1978,126592,2752,896,129344,127488
1979,126656,2688,896,129344,127552
1980,126720,2624,896,129344,127616
1981,126784,2560,896,129344,127680
1982,126848,2496,896,129344,127744
1983,126912,2432,896,129344,127808
1984,126976,2368,896,129344,127872
1985,127040,2304,896,129344,127936
1986,127104,2240,896,129344,128000
1987,127168,2176,896,129344,128064
1988,127232,2112,896,129344,128128
1989,127296,2048,896,129344,128192
1990,127360,1984,896,129344,128256
1991,127424,1920,896,129344,128320
1992,127488,1856,896,129344,128384
1993,127552,1792,896,129344,128448
1994,127616,1728,896,129344,128512
1995,127680,1664,896,129344,128576
1996,127744,1600,896,129344,128640
1997,127808,1536,896,129344,128704
1998,127872,1472,896,129344,128768
1999,127936,1408,896,129344,128832
2000,128000,1344,896,129344,128896
2001,128064,1280,896,129344,128960
2002,128128,1216,896,129344,129024
2003,128192,1152,896,129344,129088
2004,128256,1088,896,129344,129152
2005,128320,1024,896,129344,129216
2006,128384,960,896,129344,129280
2007,128448,896,896,129344,129344
2008,128512,832,896,129344,129408
2009,128576,768,896,129344,129472
2010,128640,704,896,129344,129536
2011,128704,640,896,129344,129600
2012,128768,576,896,129344,129664
2013,128832,512,896,129344,129728
2014,128896,448,896,129344,129792
2015,128960,384,896,129344,129856
2016,129024,320,896,129344,129920
2017,129088,16640,896,145728,129984
2018,129152,16576,896,145728,130048
2019,129216,16512,896,145728,130112
2020,129280,16448,896,145728,130176
2021,129344,16384,896,145728,130240
2022,129408,16320,896,145728,130304
2023,129472,16256,896,145728,130368
2024,129536,16192,896,145728,130432
2025,129600,16128,896,145728,130496
2026,129664,16064,896,145728,130560
2027,129728,16000,896,145728,130624
2028,129792,15936,896,145728,130688
2029,129856,15872,896,145728,130752
2030,129920,15808,896,145728,130816
2031,129984,15744,896,145728,130880
2032,130048,15680,896,145728,130944
2033,130112,15616,896,145728,131008
2034,130176,15552,896,145728,131072
2035,130240,15488,896,145728,131136
2036,130304,15424,896,145728,131200
2037,130368,15360,896,145728,131264
2038,130432,15296,896,145728,131328
2039,130496,15232,896,145728,131392
2040,130560,15168,896,145728,131456
2041,130624,15104,896,145728,131520
2042,130688,15040,896,145728,131584
2043,130752,14976,896,145728,131648
2044,130816,14912,896,145728,131712
2045,130880,14848,896,145728,131776
2046,130944,14784,896,145728,131840
2047,131008,14720,896,145728,131904
2048,131072,14656,896,145728,131968
2049,131136,14592,896,145728,132032
2050,131200,14528,896,145728,132096
2051,131264,14464,896,145728,132160
2052,131328,14400,896,145728,132224
2053,131392,14336,896,145728,132288
2054,131456,14272,896,145728,132352
2055,131520,14208,896,145728,132416
2056,131584,14144,896,145728,132480
2057,131648,14080,896,145728,132544
2058,131712,14016,896,145728,132608
2059,131776,13952,896,145728,132672
2060,131840,13888,896,145728,132736
2061,131904,13824,896,145728,132800
2062,131968,13760,896,145728,132864
2063,132032,13696,896,145728,132928
2064,132096,13632,896,145728,132992
2065,132160,13568,896,145728,133056
2066,132224,13504,896,145728,133120
2067,132288,13440,896,145728,133184
2068,132352,13376,896,145728,133248
2069,132416,13312,896,145728,133312
2070,132480,13248,896,145728,133376
2071,132544,13184,896,145728,133440
2072,132608,13120,896,145728,133504
2073,132672,13056,896,145728,133568
2074,132736,12992,896,145728,133632
2075,132800,12928,896,145728,133696
2076,132864,12864,896,145728,133760
2077,132928,12800,896,145728,133824
2078,132992,12736,896,145728,133888
2079,133056,12672,896,145728,133952
2080,133120,12608,896,145728,134016
2081,133184,12544,896,145728,134080
2082,133248,12480,896,145728,134144
2083,133312,12416,896,145728,134208
2084,133376,12352,896,145728,134272
2085,133440,12288,896,145728,134336
2086,133504,12224,896,145728,134400
2087,133568,12160,896,145728,134464
2088,133632,12096,896,145728,134528
2089,133696,12032,896,145728,134592
2090,133760,11968,896,145728,134656
2091,133824,11904,896,145728,134720
2092,133888,11840,896,145728,134784
2093,133952,11776,896,145728,134848
2094,134016,11712,896,145728,134912
2095,134080,11648,896,145728,134976
2096,134144,11584,896,145728,135040
2097,134208,11520,896,145728,135104
2098,134272,11456,896,145728,135168
2099,134336,11392,896,145728,135232
2100,134400,11328,896,145728,135296
2101,134464,11264,896,145728,135360
2102,134528,11200,896,145728,135424
2103,134592,11136,896,145728,135488
2104,134656,11072,896,145728,135552
2105,134720,11008,896,145728,135616
2106,134784,10944,896,145728,135680
2107,134848,10880,896,145728,135744
2108,134912,10816,896,145728,135808
2109,134976,10752,896,145728,135872
2110,135040,10688,896,145728,135936
2111,135104,10624,896,145728,136000
2112,135168,10560,896,145728,136064
2113,135232,10496,896,145728,136128
2114,135296,10432,896,145728,136192
2115,135360,10368,896,145728,136256
2116,135424,10304,896,145728,136320
2117,135488,10240,896,145728,136384
2118,135552,10176,896,145728,136448
2119,135616,10112,896,145728,136512
2120,135680,10048,896,145728,136576
2121,135744,9984,896,145728,136640
2122,135808,9920,896,145728,136704
2123,135872,9856,896,145728,136768
2124,135936,9792,896,145728,136832
2125,136000,9728,896,145728,136896
2126,136064,9664,896,145728,136960
2127,136128,9600,896,145728,137024
2128,136192,9536,896,145728,137088
2129,136256,9472,896,145728,137152
2130,136320,9408,896,145728,137216
2131,136384,9344,896,145728,137280
2132,136448,9280,896,145728,137344
2133,136512,9216,896,145728,137408
2134,136576,9152,896,145728,137472
2135,136640,9088,896,145728,137536
2136,136704,9024,896,145728,137600
2137,136768,8960,896,145728,137664
2138,136832,8896,896,145728,137728
2139,136896,8832,896,145728,137792
2140,136960,8768,896,145728,137856
2141,137024,8704,896,145728,137920
2142,137088,8640,896,145728,137984
2143,137152,8576,896,145728,138048
2144,137216,8512,896,145728,138112
2145,137280,8448,896,145728,138176
2146,137344,8384,896,145728,138240
2147,137408,8320,896,145728,138304
2148,137472,8256,896,145728,138368
2149,137536,8192,896,145728,138432
2150,137600,8128,896,145728,138496
2151,137664,8064,896,145728,138560
2152,137728,8000,896,145728,138624
2153,137792,7936,896,145728,138688
2154,137856,7872,896,145728,138752
2155,137920,7808,896,145728,138816
2156,137984,7744,896,145728,138880
2157,138048,7680,896,145728,138944
2158,138112,7616,896,145728,139008
2159,138176,7552,896,145728,139072
2160,138240,7488,896,145728,139136
2161,138304,7424,896,145728,139200
2162,138368,7360,896,145728,139264
2163,138432,7296,896,145728,139328
2164,138496,7232,896,145728,139392
2165,138560,7168,896,145728,139456
2166,138624,7104,896,145728,139520
2167,138688,7040,896,145728,139584
2168,138752,6976,896,145728,139648
2169,138816,6912,896,145728,139712
2170,138880,6848,896,145728,139776
2171,138944,6784,896,145728,139840
2172,139008,6720,896,145728,139904
2173,139072,6656,896,145728,139968
2174,139136,6592,896,145728,140032
2175,139200,6528,896,145728,140096
2176,139264,6464,896,145728,140160
2177,139328,6400,896,145728,140224
2178,139392,6336,896,145728,140288
2179,139456,6272,896,145728,140352
2180,139520,6208,896,145728,140416
2181,139584,6144,896,145728,140480
2182,139648,6080,896,145728,140544
2183,139712,6016,896,145728,140608
2184,139776,5952,896,145728,140672
2185,139840,5888,896,145728,140736
2186,139904,5824,896,145728,140800
2187,139968,5760,896,145728,140864
2188,140032,5696,896,145728,140928
2189,140096,5632,896,145728,140992
2190,140160,5568,896,145728,141056
2191,140224,5504,896,145728,141120
2192,140288,5440,896,145728,141184
2193,140352,5376,896,145728,141248
2194,140416,5312,896,145728,141312
2195,140480,5248,896,145728,141376
2196,140544,5184,896,145728,141440
2197,140608,5120,896,145728,141504
2198,140672,5056,896,145728,141568
2199,140736,4992,896,145728,141632
2200,140800,4928,896,145728,141696
2201,140864,4864,896,145728,141760
2202,140928,4800,896,145728,141824
2203,140992,4736,896,145728,141888
2204,141056,4672,896,145728,141952
2205,141120,4608,896,145728,142016
2206,141184,4544,896,145728,142080
2207,141248,4480,896,145728,142144
2208,141312,4416,896,145728,142208
2209,141376,4352,896,145728,142272
2210,141440,4288,896,145728,142336
2211,141504,4224,896,145728,142400
2212,141568,4160,896,145728,142464
2213,141632,4096,896,145728,142528
2214,141696,4032,896,145728,142592
2215,141760,3968,896,145728,142656
2216,141824,3904,896,145728,142720
2217,141888,3840,896,145728,142784
2218,141952,3776,896,145728,142848
2219,142016,3712,896,145728,142912
2220,142080,3648,896,145728,142976
2221,142144,3584,896,145728,143040
2222,142208,3520,896,145728,143104
2223,142272,3456,896,145728,143168
2224,142336,3392,896,145728,143232
2225,142400,3328,896,145728,143296
2226,142464,3264,896,145728,143360
2227,142528,3200,896,145728,143424
2228,142592,3136,896,145728,143488
2229,142656,3072,896,145728,143552
2230,142720,3008,896,145728,143616
2231,142784,2944,896,145728,143680
2232,142848,2880,896,145728,143744
2233,142912,2816,896,145728,143808
2234,142976,2752,896,145728,143872
2235,143040,2688,896,145728,143936
2236,143104,2624,896,145728,144000
2237,143168,2560,896,145728,144064
2238,143232,2496,896,145728,144128
2239,143296,2432,896,145728,144192
2240,143360,2368,896,145728,144256
2241,143424,2304,896,145728,144320
2242,143488,2240,896,145728,144384
2243,143552,2176,896,145728,144448
2244,143616,2112,896,145728,144512
2245,143680,2048,896,145728,144576
2246,143744,1984,896,145728,144640
2247,143808,1920,896,145728,144704
2248,143872,1856,896,145728,144768
2249,143936,1792,896,145728,144832
2250,144000,1728,896,145728,144896
2251,144064,1664,896,145728,144960
2252,144128,1600,896,145728,145024
2253,144192,1536,896,145728,145088
2254,144256,1472,896,145728,145152
2255,144320,1408,896,145728,145216
2256,144384,1344,896,145728,145280
2257,144448,1280,896,145728,145344
2258,144512,1216,896,145728,145408
2259,144576,1152,896,145728,145472
2260,144640,1088,896,145728,145536
2261,144704,1024,896,145728,145600
2262,144768,960,896,145728,145664
2263,144832,896,896,145728,145728
2264,144896,832,896,145728,145792
2265,144960,768,896,145728,145856
2266,145024,704,896,145728,145920
2267,145088,640,896,145728,145984
2268,145152,576,896,145728,146048
2269,145216,512,896,145728,146112
2270,145280,448,896,145728,146176
2271,145344,384,896,145728,146240
2272,145408,320,896,145728,146304
2273,145472,18688,896,164160,146368
2274,145536,18624,896,164160,146432
2275,145600,18560,896,164160,146496
2276,145664,18496,896,164160,146560
2277,145728,18432,896,164160,146624
2278,145792,18368,896,164160,146688
2279,145856,18304,896,164160,146752
2280,145920,18240,896,164160,146816
2281,145984,18176,896,164160,146880
2282,146048,18112,896,164160,146944
2283,146112,18048,896,164160,147008
2284,146176,17984,896,164160,147072
2285,146240,17920,896,164160,147136
2286,146304,17856,896,164160,147200
2287,146368,17792,896,164160,147264
2288,146432,17728,896,164160,147328
2289,146496,17664,896,164160,147392
2290,146560,17600,896,164160,147456
2291,146624,17536,896,164160,147520
2292,146688,17472,896,164160,147584
2293,146752,17408,896,164160,147648
2294,146816,17344,896,164160,147712
2295,146880,17280,896,164160,147776
2296,146944,17216,896,164160,147840
2297,147008,17152,896,164160,147904
2298,147072,17088,896,164160,147968
2299,147136,17024,896,164160,148032
2300,147200,16960,896,164160,148096
2301,147264,16896,896,164160,148160
2302,147328,16832,896,164160,148224
2303,147392,16768,896,164160,148288
2304,147456,16704,896,164160,148352
2305,147520,16640,896,164160,148416
2306,147584,16576,896,164160,148480
2307,147648,16512,896,164160,148544
2308,147712,16448,896,164160,148608
2309,147776,16384,896,164160,148672
2310,147840,16320,896,164160,148736
2311,147904,16256,896,164160,148800
2312,147968,16192,896,164160,148864
2313,148032,16128,896,164160,148928
2314,148096,16064,896,164160,148992
2315,148160,16000,896,164160,149056
2316,148224,15936,896,164160,149120
2317,148288,15872,896,164160,149184
2318,148352,15808,896,164160,149248
2319,148416,15744,896,164160,149312
2320,148480,15680,896,164160,149376
2321,148544,15616,896,164160,149440
2322,148608,15552,896,164160,149504
2323,148672,15488,896,164160,149568
2324,148736,15424,896,164160,149632
2325,148800,15360,896,164160,149696
2326,148864,15296,896,164160,149760
2327,148928,15232,896,164160,149824
2328,148992,15168,896,164160,149888
2329,149056,15104,896,164160,149952
2330,149120,15040,896,164160,150016
2331,149184,14976,896,164160,150080
2332,149248,14912,896,164160,150144
2333,149312,14848,896,164160,150208
2334,149376,14784,896,164160,150272
2335,149440,14720,896,164160,150336
2336,149504,14656,896,164160,150400
2337,149568,14592,896,164160,150464
2338,149632,14528,896,164160,150528
2339,149696,14464,896,164160,150592
2340,149760,14400,896,164160,150656
2341,149824,14336,896,164160,150720
2342,149888,14272,896,164160,150784
2343,149952,14208,896,164160,150848
2344,150016,14144,896,164160,150912
2345,150080,14080,896,164160,150976
2346,150144,14016,896,164160,151040
2347,150208,13952,896,164160,151104
2348,150272,13888,896,164160,151168
2349,150336,13824,896,164160,151232
2350,150400,13760,896,164160,151296
2351,150464,13696,896,164160,151360
2352,150528,13632,896,164160,151424
2353,150592,13568,896,164160,151488
2354,150656,13504,896,164160,151552
2355,150720,13440,896,164160,151616
2356,150784,13376,896,164160,151680
2357,150848,13312,896,164160,151744
2358,150912,13248,896,164160,151808
2359,150976,13184,896,164160,151872
2360,151040,13120,896,164160,151936
2361,151104,13056,896,164160,152000
2362,151168,12992,896,164160,152064
2363,151232,12928,896,164160,152128
2364,151296,12864,896,164160,152192
2365,151360,12800,896,164160,152256
2366,151424,12736,896,164160,152320
2367,151488,12672,896,164160,152384
2368,151552,12608,896,164160,152448
2369,151616,12544,896,164160,152512
2370,151680,12480,896,164160,152576
2371,151744,12416,896,164160,152640
2372,151808,12352,896,164160,152704
2373,151872,12288,896,164160,152768
2374,151936,12224,896,164160,152832
2375,152000,12160,896,164160,152896
2376,152064,12096,896,164160,152960
2377,152128,12032,896,164160,153024
2378,152192,11968,896,164160,153088
2379,152256,11904,896,164160,153152
2380,152320,11840,896,164160,153216
2381,152384,11776,896,164160,153280
2382,152448,11712,896,164160,153344
2383,152512,11648,896,164160,153408
2384,152576,11584,896,164160,153472
2385,152640,11520,896,164160,153536
2386,152704,11456,896,164160,153600
2387,152768,11392,896,164160,153664
2388,152832,11328,896,164160,153728
2389,152896,11264,896,164160,153792
2390,152960,11200,896,164160,153856
2391,153024,11136,896,164160,153920
2392,153088,11072,896,164160,153984
2393,153152,11008,896,164160,154048
2394,153216,10944,896,164160,154112
2395,153280,10880,896,164160,154176
2396,153344,10816,896,164160,154240
2397,153408,10752,896,164160,154304
2398,153472,10688,896,164160,154368
2399,153536,10624,896,164160,154432
2400,153600,10560,896,164160,154496
2401,153664,10496,896,164160,154560
2402,153728,10432,896,164160,154624
2403,153792,10368,896,164160,154688
2404,153856,10304,896,164160,154752
2405,153920,10240,896,164160,154816
2406,153984,10176,896,164160,154880
2407,154048,10112,896,164160,154944
2408,154112,10048,896,164160,155008
2409,154176,9984,896,164160,155072
2410,154240,9920,896,164160,155136
2411,154304,9856,896,164160,155200
2412,154368,9792,896,164160,155264
2413,154432,9728,896,164160,155328
2414,154496,9664,896,164160,155392
2415,154560,9600,896,164160,155456
2416,154624,9536,896,164160,155520
2417,154688,9472,896,164160,155584
2418,154752,9408,896,164160,155648
2419,154816,9344,896,164160,155712
2420,154880,9280,896,164160,155776
2421,154944,9216,896,164160,155840
2422,155008,9152,896,164160,155904
2423,155072,9088,896,164160,155968
2424,155136,9024,896,164160,156032
2425,155200,8960,896,164160,156096
2426,155264,8896,896,164160,156160
2427,155328,8832,896,164160,156224
2428,155392,8768,896,164160,156288
2429,155456,8704,896,164160,156352
2430,155520,8640,896,164160,156416
2431,155584,8576,896,164160,156480
2432,155648,8512,896,164160,156544
2433,155712,8448,896,164160,156608
2434,155776,8384,896,164160,156672
2435,155840,8320,896,164160,156736
2436,155904,8256,896,164160,156800
2437,155968,8192,896,164160,156864
2438,156032,8128,896,164160,156928
2439,156096,8064,896,164160,156992
2440,156160,8000,896,164160,157056
2441,156224,7936,896,164160,157120
2442,156288,7872,896,164160,157184
2443,156352,7808,896,164160,157248
2444,156416,7744,896,164160,157312
2445,156480,7680,896,164160,157376
2446,156544,7616,896,164160,157440
2447,156608,7552,896,164160,157504
2448,156672,7488,896,164160,157568
2449,156736,7424,896,164160,157632
2450,156800,7360,896,164160,157696
2451,156864,7296,896,164160,157760
2452,156928,7232,896,164160,157824
2453,156992,7168,896,164160,157888
2454,157056,7104,896,164160,157952
2455,157120,7040,896,164160,158016
2456,157184,6976,896,164160,158080
2457,157248,6912,896,164160,158144
2458,157312,6848,896,164160,158208
2459,157376,6784,896,164160,158272
2460,157440,6720,896,164160,158336
2461,157504,6656,896,164160,158400
2462,157568,6592,896,164160,158464
2463,157632,6528,896,164160,158528
2464,157696,6464,896,164160,158592
2465,157760,6400,896,164160,158656
2466,157824,6336,896,164160,158720
2467,157888,6272,896,164160,158784
2468,157952,6208,896,164160,158848
2469,158016,6144,896,164160,158912
2470,158080,6080,896,164160,158976
2471,158144,6016,896,164160,159040
2472,158208,5952,896,164160,159104
2473,158272,5888,896,164160,159168
2474,158336,5824,896,164160,159232
2475,158400,5760,896,164160,159296
2476,158464,5696,896,164160,159360
2477,158528,5632,896,164160,159424
2478,158592,5568,896,164160,159488
2479,158656,5504,896,164160,159552
2480,158720,5440,896,164160,159616
2481,158784,5376,896,164160,159680
2482,158848,5312,896,164160,159744
2483,158912,5248,896,164160,159808
2484,158976,5184,896,164160,159872
2485,159040,5120,896,164160,159936
2486,159104,5056,896,164160,160000
2487,159168,4992,896,164160,160064
2488,159232,4928,896,164160,160128
2489,159296,4864,896,164160,160192
2490,159360,4800,896,164160,160256
2491,159424,4736,896,164160,160320
2492,159488,4672,896,164160,160384
2493,159552,4608,896,164160,160448
2494,159616,4544,896,164160,160512
2495,159680,4480,896,164160,160576
2496,159744,4416,896,164160,160640
2497,159808,4352,896,164160,160704
2498,159872,4288,896,164160,160768
2499,159936,4224,896,164160,160832
2500,160000,4160,896,164160,160896
2501,160064,4096,896,164160,160960
2502,160128,4032,896,164160,161024
2503,160192,3968,896,164160,161088
2504,160256,3904,896,164160,161152
2505,160320,3840,896,164160,161216
2506,160384,3776,896,164160,161280
2507,160448,3712,896,164160,161344
2508,160512,3648,896,164160,161408
2509,160576,3584,896,164160,161472
2510,160640,3520,896,164160,161536
2511,160704,3456,896,164160,161600
2512,160768,3392,896,164160,161664
2513,160832,3328,896,164160,161728
2514,160896,3264,896,164160,161792
2515,160960,3200,896,164160,161856
2516,161024,3136,896,164160,161920
2517,161088,3072,896,164160,161984
2518,161152,3008,896,164160,162048
2519,161216,2944,896,164160,162112
2520,161280,2880,896,164160,162176
2521,161344,2816,896,164160,162240
2522,161408,2752,896,164160,162304
2523,161472,2688,896,164160,162368
2524,161536,2624,896,164160,162432
2525,161600,2560,896,164160,162496
2526,161664,2496,896,164160,162560
2527,161728,2432,896,164160,162624
2528,161792,2368,896,164160,162688
2529,161856,2304,896,164160,162752
2530,161920,2240,896,164160,162816
2531,161984,2176,896,164160,162880
2532,162048,2112,896,164160,162944
2533,162112,2048,896,164160,163008
2534,162176,1984,896,164160,163072
2535,162240,1920,896,164160,163136
2536,162304,1856,896,164160,163200
2537,162368,1792,896,164160,163264
2538,162432,1728,896,164160,163328
2539,162496,1664,896,164160,163392
2540,162560,1600,896,164160,163456
2541,162624,1536,896,164160,163520
2542,162688,1472,896,164160,163584
2543,162752,1408,896,164160,163648
2544,162816,1344,896,164160,163712
2545,162880,1280,896,164160,163776
2546,162944,1216,896,164160,163840
2547,163008,1152,896,164160,163904
2548,163072,1088,896,164160,163968
2549,163136,1024,896,164160,164032
2550,163200,960,896,164160,164096
2551,163264,896,896,164160,164160
2552,163328,832,896,164160,164224
2553,163392,768,896,164160,164288
2554,163456,704,896,164160,164352
2555,163520,640,896,164160,164416
2556,163584,576,896,164160,164480
2557,163648,512,896,164160,164544
2558,163712,448,896,164160,164608
2559,163776,384,896,164160,164672
2560,163840,320,896,164160,164736
2561,163904,20992,896,184896,164800
2562,163968,20928,896,184896,164864
2563,164032,20864,896,184896,164928
2564,164096,20800,896,184896,164992
2565,164160,20736,896,184896,165056
2566,164224,20672,896,184896,165120
2567,164288,20608,896,184896,165184
2568,164352,20544,896,184896,165248
2569,164416,20480,896,184896,165312
2570,164480,20416,896,184896,165376
2571,164544,20352,896,184896,165440
2572,164608,20288,896,184896,165504
2573,164672,20224,896,184896,165568
2574,164736,20160,896,184896,165632
2575,164800,20096,896,184896,165696
2576,164864,20032,896,184896,165760
2577,164928,19968,896,184896,165824
2578,164992,19904,896,184896,165888
2579,165056,19840,896,184896,165952
2580,165120,19776,896,184896,166016
2581,165184,19712,896,184896,166080
2582,165248,19648,896,184896,166144
2583,165312,19584,896,184896,166208
2584,165376,19520,896,184896,166272
2585,165440,19456,896,184896,166336
2586,165504,19392,896,184896,166400
2587,165568,19328,896,184896,166464
2588,165632,19264,896,184896,166528
2589,165696,19200,896,184896,166592
2590,165760,19136,896,184896,166656
2591,165824,19072,896,184896,166720
2592,165888,19008,896,184896,166784
2593,165952,18944,896,184896,166848
2594,166016,18880,896,184896,166912
2595,166080,18816,896,184896,166976
2596,166144,18752,896,184896,167040
2597,166208,18688,896,184896,167104
2598,166272,18624,896,184896,167168
2599,166336,18560,896,184896,167232
2600,166400,18496,896,184896,167296
2601,166464,18432,896,184896,167360
2602,166528,18368,896,184896,167424
2603,166592,18304,896,184896,167488
2604,166656,18240,896,184896,167552
2605,166720,18176,896,184896,167616
2606,166784,18112,896,184896,167680
2607,166848,18048,896,184896,167744
2608,166912,17984,896,184896,167808
2609,166976,17920,896,184896,167872
2610,167040,17856,896,184896,167936
2611,167104,17792,896,184896,168000
2612,167168,17728,896,184896,168064
2613,167232,17664,896,184896,168128
2614,167296,17600,896,184896,168192
2615,167360,17536,896,184896,168256
2616,167424,17472,896,184896,168320
2617,167488,17408,896,184896,168384
2618,167552,17344,896,184896,168448
2619,167616,17280,896,184896,168512
2620,167680,17216,896,184896,168576
2621,167744,17152,896,184896,168640
2622,167808,17088,896,184896,168704
2623,167872,17024,896,184896,168768
2624,167936,16960,896,184896,168832
2625,168000,16896,896,184896,168896
2626,168064,16832,896,184896,168960
2627,168128,16768,896,184896,169024
2628,168192,16704,896,184896,169088
2629,168256,16640,896,184896,169152
2630,168320,16576,896,184896,169216
2631,168384,16512,896,184896,169280
2632,168448,16448,896,184896,169344
2633,168512,16384,896,184896,169408
2634,168576,16320,896,184896,169472
2635,168640,16256,896,184896,169536
2636,168704,16192,896,184896,169600
2637,168768,16128,896,184896,169664
2638,168832,16064,896,184896,169728
2639,168896,16000,896,184896,169792
2640,168960,15936,896,184896,169856
2641,169024,15872,896,184896,169920
2642,169088,15808,896,184896,169984
2643,169152,15744,896,184896,170048
2644,169216,15680,896,184896,170112
2645,169280,15616,896,184896,170176
2646,169344,15552,896,184896,170240
2647,169408,15488,896,184896,170304
2648,169472,15424,896,184896,170368
2649,169536,15360,896,184896,170432
2650,169600,15296,896,184896,170496
2651,169664,15232,896,184896,170560
2652,169728,15168,896,184896,170624
2653,169792,15104,896,184896,170688
2654,169856,15040,896,184896,170752
2655,169920,14976,896,184896,170816
2656,169984,14912,896,184896,170880
2657,170048,14848,896,184896,170944
2658,170112,14784,896,184896,171008
2659,170176,14720,896,184896,171072
2660,170240,14656,896,184896,171136
2661,170304,14592,896,184896,171200
2662,170368,14528,896,184896,171264
2663,170432,14464,896,184896,171328
2664,170496,14400,896,184896,171392
2665,170560,14336,896,184896,171456
2666,170624,14272,896,184896,171520
2667,170688,14208,896,184896,171584
2668,170752,14144,896,184896,171648
2669,170816,14080,896,184896,171712
2670,170880,14016,896,184896,171776
2671,170944,13952,896,184896,171840
2672,171008,13888,896,184896,171904
2673,171072,13824,896,184896,171968
2674,171136,13760,896,184896,172032
2675,171200,13696,896,184896,172096
2676,171264,13632,896,184896,172160
2677,171328,13568,896,184896,172224
2678,171392,13504,896,184896,172288
2679,171456,13440,896,184896,172352
2680,171520,13376,896,184896,172416
2681,171584,13312,896,184896,172480
2682,171648,13248,896,184896,172544
2683,171712,13184,896,184896,172608
2684,171776,13120,896,184896,172672
2685,171840,13056,896,184896,172736
2686,171904,12992,896,184896,172800
2687,171968,12928,896,184896,172864
2688,172032,12864,896,184896,172928
2689,172096,12800,896,184896,172992
2690,172160,12736,896,184896,173056
2691,172224,12672,896,184896,173120
2692,172288,12608,896,184896,173184
2693,172352,12544,896,184896,173248
2694,172416,12480,896,184896,173312
2695,172480,12416,896,184896,173376
2696,172544,12352,896,184896,173440
2697,172608,12288,896,184896,173504
2698,172672,12224,896,184896,173568
2699,172736,12160,896,184896,173632
2700,172800,12096,896,184896,173696
2701,172864,12032,896,184896,173760
2702,172928,11968,896,184896,173824
2703,172992,11904,896,184896,173888
2704,173056,11840,896,184896,173952
2705,173120,11776,896,184896,174016
2706,173184,11712,896,184896,174080
2707,173248,11648,896,184896,174144
2708,173312,11584,896,184896,174208
2709,173376,11520,896,184896,174272
2710,173440,11456,896,184896,174336
2711,173504,11392,896,184896,174400
2712,173568,11328,896,184896,174464
2713,173632,11264,896,184896,174528
2714,173696,11200,896,184896,174592
2715,173760,11136,896,184896,174656
2716,173824,11072,896,184896,174720
2717,173888,11008,896,184896,174784
2718,173952,10944,896,184896,174848
2719,174016,10880,896,184896,174912
2720,174080,10816,896,184896,174976
2721,174144,10752,896,184896,175040
2722,174208,10688,896,184896,175104
2723,174272,10624,896,184896,175168
2724,174336,10560,896,184896,175232
2725,174400,10496,896,184896,175296
2726,174464,10432,896,184896,175360
2727,174528,10368,896,184896,175424
2728,174592,10304,896,184896,175488
2729,174656,10240,896,184896,175552
2730,174720,10176,896,184896,175616
2731,174784,10112,896,184896,175680
2732,174848,10048,896,184896,175744
2733,174912,9984,896,184896,175808
2734,174976,9920,896,184896,175872
2735,175040,9856,896,184896,175936
2736,175104,9792,896,184896,176000
2737,175168,9728,896,184896,176064
2738,175232,9664,896,184896,176128
2739,175296,9600,896,184896,176192
2740,175360,9536,896,184896,176256
2741,175424,9472,896,184896,176320
2742,175488,9408,896,184896,176384
2743,175552,9344,896,184896,176448
2744,175616,9280,896,184896,176512
2745,175680,9216,896,184896,176576
2746,175744,9152,896,184896,176640
2747,175808,9088,896,184896,176704
2748,175872,9024,896,184896,176768
2749,175936,8960,896,184896,176832
2750,176000,8896,896,184896,176896
2751,176064,8832,896,184896,176960
2752,176128,8768,896,184896,177024
2753,176192,8704,896,184896,177088
2754,176256,8640,896,184896,177152
2755,176320,8576,896,184896,177216
2756,176384,8512,896,184896,177280
2757,176448,8448,896,184896,177344
2758,176512,8384,896,184896,177408
2759,176576,8320,896,184896,177472
2760,176640,8256,896,184896,177536
2761,176704,8192,896,184896,177600
2762,176768,8128,896,184896,177664
2763,176832,8064,896,184896,177728
2764,176896,8000,896,184896,177792
2765,176960,7936,896,184896,177856
2766,177024,7872,896,184896,177920
2767,177088,7808,896,184896,177984
2768,177152,7744,896,184896,178048
2769,177216,7680,896,184896,178112
2770,177280,7616,896,184896,178176
2771,177344,7552,896,184896,178240
2772,177408,7488,896,184896,178304
2773,177472,7424,896,184896,178368
2774,177536,7360,896,184896,178432
2775,177600,7296,896,184896,178496
2776,177664,7232,896,184896,178560
2777,177728,7168,896,184896,178624
2778,177792,7104,896,184896,178688
2779,177856,7040,896,184896,178752
2780,177920,6976,896,184896,178816
2781,177984,6912,896,184896,178880
2782,178048,6848,896,184896,178944
2783,178112,6784,896,184896,179008
2784,178176,6720,896,184896,179072
2785,178240,6656,896,184896,179136
2786,178304,6592,896,184896,179200
2787,178368,6528,896,184896,179264
2788,178432,6464,896,184896,179328
2789,178496,6400,896,184896,179392
2790,178560,6336,896,184896,179456
2791,178624,6272,896,184896,179520
2792,178688,6208,896,184896,179584
2793,178752,6144,896,184896,179648
2794,178816,6080,896,184896,179712
2795,178880,6016,896,184896,179776
2796,178944,5952,896,184896,179840
2797,179008,5888,896,184896,179904
2798,179072,5824,896,184896,179968
2799,179136,5760,896,184896,180032
2800,179200,5696,896,184896,180096
2801,179264,5632,896,184896,180160
2802,179328,5568,896,184896,180224
2803,179392,5504,896,184896,180288
2804,179456,5440,896,184896,180352
2805,179520,5376,896,184896,180416
2806,179584,5312,896,184896,180480
2807,179648,5248,896,184896,180544
2808,179712,5184,896,184896,180608
2809,179776,5120,896,184896,180672
2810,179840,5056,896,184896,180736
2811,179904,4992,896,184896,180800
2812,179968,4928,896,184896,180864
2813,180032,4864,896,184896,180928
2814,180096,4800,896,184896,180992
2815,180160,4736,896,184896,181056
2816,180224,4672,896,184896,181120
2817,180288,4608,896,184896,181184
2818,180352,4544,896,184896,181248
2819,180416,4480,896,184896,181312
2820,180480,4416,896,184896,181376
2821,180544,4352,896,184896,181440
2822,180608,4288,896,184896,181504
2823,180672,4224,896,184896,181568
2824,180736,4160,896,184896,181632
2825,180800,4096,896,184896,181696
2826,180864,4032,896,184896,181760
2827,180928,3968,896,184896,181824
2828,180992,3904,896,184896,181888
2829,181056,3840,896,184896,181952
2830,181120,3776,896,184896,182016
2831,181184,3712,896,184896,182080
2832,181248,3648,896,184896,182144
2833,181312,3584,896,184896,182208
2834,181376,3520,896,184896,182272
2835,181440,3456,896,184896,182336
2836,181504,3392,896,184896,182400
2837,181568,3328,896,184896,182464
2838,181632,3264,896,184896,182528
2839,181696,3200,896,184896,182592
2840,181760,3136,896,184896,182656
2841,181824,3072,896,184896,182720
2842,181888,3008,896,184896,182784
2843,181952,2944,896,184896,182848
2844,182016,2880,896,184896,182912
2845,182080,2816,896,184896,182976
2846,182144,2752,896,184896,183040
2847,182208,2688,896,184896,183104
2848,182272,2624,896,184896,183168
2849,182336,2560,896,184896,183232
2850,182400,2496,896,184896,183296
2851,182464,2432,896,184896,183360
2852,182528,2368,896,184896,183424
2853,182592,2304,896,184896,183488
2854,182656,2240,896,184896,183552
2855,182720,2176,896,184896,183616
2856,182784,2112,896,184896,183680
2857,182848,2048,896,184896,183744
2858,182912,1984,896,184896,183808
2859,182976,1920,896,184896,183872
2860,183040,1856,896,184896,183936
2861,183104,1792,896,184896,184000
2862,183168,1728,896,184896,184064
2863,183232,1664,896,184896,184128
2864,183296,1600,896,184896,184192
2865,183360,1536,896,184896,184256
2866,183424,1472,896,184896,184320
2867,183488,1408,896,184896,184384
2868,183552,1344,896,184896,184448
2869,183616,1280,896,184896,184512
2870,183680,1216,896,184896,184576
2871,183744,1152,896,184896,184640
2872,183808,1088,896,184896,184704
2873,183872,1024,896,184896,184768
2874,183936,960,896,184896,184832
2875,184000,896,896,184896,184896
2876,184064,832,896,184896,184960
2877,184128,768,896,184896,185024
2878,184192,704,896,184896,185088
2879,184256,640,896,184896,185152
2880,184320,576,896,184896,185216
2881,184384,512,896,184896,185280
2882,184448,448,896,184896,185344
2883,184512,384,896,184896,185408
2884,184576,320,896,184896,185472
2885,184640,23552,896,208192,185536
2886,184704,23488,896,208192,185600
2887,184768,23424,896,208192,185664
2888,184832,23360,896,208192,185728
2889,184896,23296,896,208192,185792
2890,184960,23232,896,208192,185856
2891,185024,23168,896,208192,185920
2892,185088,23104,896,208192,185984
2893,185152,23040,896,208192,186048
2894,185216,22976,896,208192,186112
2895,185280,22912,896,208192,186176
2896,185344,22848,896,208192,186240
2897,185408,22784,896,208192,186304
2898,185472,22720,896,208192,186368
2899,185536,22656,896,208192,186432
2900,185600,22592,896,208192,186496
2901,185664,22528,896,208192,186560
2902,185728,22464,896,208192,186624
2903,185792,22400,896,208192,186688
2904,185856,22336,896,208192,186752
2905,185920,22272,896,208192,186816
2906,185984,22208,896,208192,186880
2907,186048,22144,896,208192,186944
2908,186112,22080,896,208192,187008
2909,186176,22016,896,208192,187072
2910,186240,21952,896,208192,187136
2911,186304,21888,896,208192,187200
2912,186368,21824,896,208192,187264
2913,186432,21760,896,208192,187328
2914,186496,21696,896,208192,187392
2915,186560,21632,896,208192,187456
2916,186624,21568,896,208192,187520
2917,186688,21504,896,208192,187584
2918,186752,21440,896,208192,187648
2919,186816,21376,896,208192,187712
2920,186880,21312,896,208192,187776
2921,186944,21248,896,208192,187840
2922,187008,21184,896,208192,187904
2923,187072,21120,896,208192,187968
2924,187136,21056,896,208192,188032
2925,187200,20992,896,208192,188096
2926,187264,20928,896,208192,188160
2927,187328,20864,896,208192,188224
2928,187392,20800,896,208192,188288
2929,187456,20736,896,208192,188352
2930,187520,20672,896,208192,188416
2931,187584,20608,896,208192,188480
2932,187648,20544,896,208192,188544
2933,187712,20480,896,208192,188608
2934,187776,20416,896,208192,188672
2935,187840,20352,896,208192,188736
2936,187904,20288,896,208192,188800
2937,187968,20224,896,208192,188864
2938,188032,20160,896,208192,188928
2939,188096,20096,896,208192,188992
2940,188160,20032,896,208192,189056
2941,188224,19968,896,208192,189120
2942,188288,19904,896,208192,189184
2943,188352,19840,896,208192,189248
2944,188416,19776,896,208192,189312
2945,188480,19712,896,208192,189376
2946,188544,19648,896,208192,189440
2947,188608,19584,896,208192,189504
2948,188672,19520,896,208192,189568
2949,188736,19456,896,208192,189632
2950,188800,19392,896,208192,189696
2951,188864,19328,896,208192,189760
2952,188928,19264,896,208192,189824
2953,188992,19200,896,208192,189888
2954,189056,19136,896,208192,189952
2955,189120,19072,896,208192,190016
2956,189184,19008,896,208192,190080
2957,189248,18944,896,208192,190144
2958,189312,18880,896,208192,190208
2959,189376,18816,896,208192,190272
2960,189440,18752,896,208192,190336
2961,189504,18688,896,208192,190400
2962,189568,18624,896,208192,190464
2963,189632,18560,896,208192,190528
2964,189696,18496,896,208192,190592
2965,189760,18432,896,208192,190656
2966,189824,18368,896,208192,190720
2967,189888,18304,896,208192,190784
2968,189952,18240,896,208192,190848
2969,190016,18176,896,208192,190912
2970,190080,18112,896,208192,190976
2971,190144,18048,896,208192,191040
2972,190208,17984,896,208192,191104
2973,190272,17920,896,208192,191168
2974,190336,17856,896,208192,191232
2975,190400,17792,896,208192,191296
2976,190464,17728,896,208192,191360
2977,190528,17664,896,208192,191424
2978,190592,17600,896,208192,191488
2979,190656,17536,896,208192,191552
2980,190720,17472,896,208192,191616
2981,190784,17408,896,208192,191680
2982,190848,17344,896,208192,191744
2983,190912,17280,896,208192,191808
2984,190976,17216,896,208192,191872
2985,191040,17152,896,208192,191936
2986,191104,17088,896,208192,192000
2987,191168,17024,896,208192,192064
2988,191232,16960,896,208192,192128
2989,191296,16896,896,208192,192192
2990,191360,16832,896,208192,192256
2991,191424,16768,896,208192,192320
2992,191488,16704,896,208192,192384
2993,191552,16640,896,208192,192448
2994,191616,16576,896,208192,192512
2995,191680,16512,896,208192,192576
2996,191744,16448,896,208192,192640
2997,191808,16384,896,208192,192704
2998,191872,16320,896,208192,192768
2999,191936,16256,896,208192,192832
3000,192000,16192,896,208192,192896
3001,192064,16128,896,208192,192960
3002,192128,16064,896,208192,193024
3003,192192,16000,896,208192,193088
3004,192256,15936,896,208192,193152
3005,192320,15872,896,208192,193216
3006,192384,15808,896,208192,193280
3007,192448,15744,896,208192,193344
3008,192512,15680,896,208192,193408
3009,192576,15616,896,208192,193472
3010,192640,15552,896,208192,193536
3011,192704,15488,896,208192,193600
3012,192768,15424,896,208192,193664
3013,192832,15360,896,208192,193728
3014,192896,15296,896,208192,193792
3015,192960,15232,896,208192,193856
3016,193024,15168,896,208192,193920
3017,193088,15104,896,208192,193984
3018,193152,15040,896,208192,194048
3019,193216,14976,896,208192,194112
3020,193280,14912,896,208192,194176
3021,193344,14848,896,208192,194240
3022,193408,14784,896,208192,194304
3023,193472,14720,896,208192,194368
3024,193536,14656,896,208192,194432
3025,193600,14592,896,208192,194496
3026,193664,14528,896,208192,194560
3027,193728,14464,896,208192,194624
3028,193792,14400,896,208192,194688
3029,193856,14336,896,208192,194752
3030,193920,14272,896,208192,194816
3031,193984,14208,896,208192,194880
3032,194048,14144,896,208192,194944
3033,194112,14080,896,208192,195008
3034,194176,14016,896,208192,195072
3035,194240,13952,896,208192,195136
3036,194304,13888,896,208192,195200
3037,194368,13824,896,208192,195264
3038,194432,13760,896,208192,195328
3039,194496,13696,896,208192,195392
3040,194560,13632,896,208192,195456
3041,194624,13568,896,208192,195520
3042,194688,13504,896,208192,195584
3043,194752,13440,896,208192,195648
3044,194816,13376,896,208192,195712
3045,194880,13312,896,208192,195776
3046,194944,13248,896,208192,195840
3047,195008,13184,896,208192,195904
3048,195072,13120,896,208192,195968
3049,195136,13056,896,208192,196032
3050,195200,12992,896,208192,196096
3051,195264,12928,896,208192,196160
3052,195328,12864,896,208192,196224
3053,195392,12800,896,208192,196288
3054,195456,12736,896,208192,196352
3055,195520,12672,896,208192,196416
3056,195584,12608,896,208192,196480
3057,195648,12544,896,208192,196544
3058,195712,12480,896,208192,196608
3059,195776,12416,896,208192,196672
3060,195840,12352,896,208192,196736
3061,195904,12288,896,208192,196800
3062,195968,12224,896,208192,196864
3063,196032,12160,896,208192,196928
3064,196096,12096,896,208192,196992
3065,196160,12032,896,208192,197056
3066,196224,11968,896,208192,197120
3067,196288,11904,896,208192,197184
3068,196352,11840,896,208192,197248
3069,196416,11776,896,208192,197312
3070,196480,11712,896,208192,197376
3071,196544,11648,896,208192,197440
3072,196608,11584,896,208192,197504
3073,196672,11520,896,208192,197568
3074,196736,11456,896,208192,197632
3075,196800,11392,896,208192,197696
3076,196864,11328,896,208192,197760
3077,196928,11264,896,208192,197824
3078,196992,11200,896,208192,197888
3079,197056,11136,896,208192,197952
3080,197120,11072,896,208192,198016
3081,197184,11008,896,208192,198080
3082,197248,10944,896,208192,198144
3083,197312,10880,896,208192,198208
3084,197376,10816,896,208192,198272
3085,197440,10752,896,208192,198336
3086,197504,10688,896,208192,198400
3087,197568,10624,896,208192,198464
3088,197632,10560,896,208192,198528
3089,197696,10496,896,208192,198592
3090,197760,10432,896,208192,198656
3091,197824,10368,896,208192,198720
3092,197888,10304,896,208192,198784
3093,197952,10240,896,208192,198848
3094,198016,10176,896,208192,198912
3095,198080,10112,896,208192,198976
3096,198144,10048,896,208192,199040
3097,198208,9984,896,208192,199104
3098,198272,9920,896,208192,199168
3099,198336,9856,896,208192,199232
3100,198400,9792,896,208192,199296
3101,198464,9728,896,208192,199360
3102,198528,9664,896,208192,199424
3103,198592,9600,896,208192,199488
3104,198656,9536,896,208192,199552
3105,198720,9472,896,208192,199616
3106,198784,9408,896,208192,199680
3107,198848,9344,896,208192,199744
3108,198912,9280,896,208192,199808
3109,198976,9216,896,208192,199872
3110,199040,9152,896,208192,199936
3111,199104,9088,896,208192,200000
3112,199168,9024,896,208192,200064
3113,199232,8960,896,208192,200128
3114,199296,8896,896,208192,200192
3115,199360,8832,896,208192,200256
3116,199424,8768,896,208192,200320
3117,199488,8704,896,208192,200384
3118,199552,8640,896,208192,200448
3119,199616,8576,896,208192,200512
3120,199680,8512,896,208192,200576
3121,199744,8448,896,208192,200640
3122,199808,8384,896,208192,200704
3123,199872,8320,896,208192,200768
3124,199936,8256,896,208192,200832
3125,200000,8192,896,208192,200896
3126,200064,8128,896,208192,200960
3127,200128,8064,896,208192,201024
3128,200192,8000,896,208192,201088
3129,200256,7936,896,208192,201152
3130,200320,7872,896,208192,201216
3131,200384,7808,896,208192,201280
3132,200448,7744,896,208192,201344
3133,200512,7680,896,208192,201408
3134,200576,7616,896,208192,201472
3135,200640,7552,896,208192,201536
3136,200704,7488,896,208192,201600
3137,200768,7424,896,208192,201664
3138,200832,7360,896,208192,201728
3139,200896,7296,896,208192,201792
3140,200960,7232,896,208192,201856
3141,201024,7168,896,208192,201920
3142,201088,7104,896,208192,201984
3143,201152,7040,896,208192,202048
3144,201216,6976,896,208192,202112
3145,201280,6912,896,208192,202176
3146,201344,6848,896,208192,202240
3147,201408,6784,896,208192,202304
3148,201472,6720,896,208192,202368
3149,201536,6656,896,208192,202432
3150,201600,6592,896,208192,202496
3151,201664,6528,896,208192,202560
3152,201728,6464,896,208192,202624
3153,201792,6400,896,208192,202688
3154,201856,6336,896,208192,202752
3155,201920,6272,896,208192,202816
3156,201984,6208,896,208192,202880
3157,202048,6144,896,208192,202944
3158,202112,6080,896,208192,203008
3159,202176,6016,896,208192,203072
3160,202240,5952,896,208192,203136
3161,202304,5888,896,208192,203200
3162,202368,5824,896,208192,203264
3163,202432,5760,896,208192,203328
3164,202496,5696,896,208192,203392
3165,202560,5632,896,208192,203456
3166,202624,5568,896,208192,203520
3167,202688,5504,896,208192,203584
3168,202752,5440,896,208192,203648
3169,202816,5376,896,208192,203712
3170,202880,5312,896,208192,203776
3171,202944,5248,896,208192,203840
3172,203008,5184,896,208192,203904
3173,203072,5120,896,208192,203968
3174,203136,5056,896,208192,204032
3175,203200,4992,896,208192,204096
3176,203264,4928,896,208192,204160
3177,203328,4864,896,208192,204224
3178,203392,4800,896,208192,204288
3179,203456,4736,896,208192,204352
3180,203520,4672,896,208192,204416
3181,203584,4608,896,208192,204480
3182,203648,4544,896,208192,204544
3183,203712,4480,896,208192,204608
3184,203776,4416,896,208192,204672
3185,203840,4352,896,208192,204736
3186,203904,4288,896,208192,204800
3187,203968,4224,896,208192,204864
3188,204032,4160,896,208192,204928
3189,204096,4096,896,208192,204992
3190,204160,4032,896,208192,205056
3191,204224,3968,896,208192,205120
3192,204288,3904,896,208192,205184
3193,204352,3840,896,208192,205248
3194,204416,3776,896,208192,205312
3195,204480,3712,896,208192,205376
3196,204544,3648,896,208192,205440
3197,204608,3584,896,208192,205504
3198,204672,3520,896,208192,205568
3199,204736,3456,896,208192,205632
3200,204800,3392,896,208192,205696
3201,204864,3328,896,208192,205760
3202,204928,3264,896,208192,205824
3203,204992,3200,896,208192,205888
3204,205056,3136,896,208192,205952
3205,205120,3072,896,208192,206016
3206,205184,3008,896,208192,206080
3207,205248,2944,896,208192,206144
3208,205312,2880,896,208192,206208
3209,205376,2816,896,208192,206272
3210,205440,2752,896,208192,206336
3211,205504,2688,896,208192,206400
3212,205568,2624,896,208192,206464
3213,205632,2560,896,208192,206528
3214,205696,2496,896,208192,206592
3215,205760,2432,896,208192,206656
3216,205824,2368,896,208192,206720
3217,205888,2304,896,208192,206784
3218,205952,2240,896,208192,206848
3219,206016,2176,896,208192,206912
3220,206080,2112,896,208192,206976
3221,206144,2048,896,208192,207040
3222,206208,1984,896,208192,207104
3223,206272,1920,896,208192,207168
3224,206336,1856,896,208192,207232
3225,206400,1792,896,208192,207296
3226,206464,1728,896,208192,207360
3227,206528,1664,896,208192,207424
3228,206592,1600,896,208192,207488
3229,206656,1536,896,208192,207552
3230,206720,1472,896,208192,207616
3231,206784,1408,896,208192,207680
3232,206848,1344,896,208192,207744
3233,206912,1280,896,208192,207808
3234,206976,1216,896,208192,207872
3235,207040,1152,896,208192,207936
3236,207104,1088,896,208192,208000
3237,207168,1024,896,208192,208064
3238,207232,960,896,208192,208128
3239,207296,896,896,208192,208192
3240,207360,832,896,208192,208256
3241,207424,768,896,208192,208320
3242,207488,704,896,208192,208384
3243,207552,640,896,208192,208448
3244,207616,576,896,208192,208512
3245,207680,512,896,208192,208576
3246,207744,448,896,208192,208640
3247,207808,384,896,208192,208704
3248,207872,320,896,208192,208768
3249,207936,26624,896,234560,208832
3250,208000,26560,896,234560,208896
3251,208064,26496,896,234560,208960
3252,208128,26432,896,234560,209024
3253,208192,26368,896,234560,209088
3254,208256,26304,896,234560,209152
3255,208320,26240,896,234560,209216
3256,208384,26176,896,234560,209280
3257,208448,26112,896,234560,209344
3258,208512,26048,896,234560,209408
3259,208576,25984,896,234560,209472
3260,208640,25920,896,234560,209536
3261,208704,25856,896,234560,209600
3262,208768,25792,896,234560,209664
3263,208832,25728,896,234560,209728
3264,208896,25664,896,234560,209792
3265,208960,25600,896,234560,209856
3266,209024,25536,896,234560,209920
3267,209088,25472,896,234560,209984
3268,209152,25408,896,234560,210048
3269,209216,25344,896,234560,210112
3270,209280,25280,896,234560,210176
3271,209344,25216,896,234560,210240
3272,209408,25152,896,234560,210304
3273,209472,25088,896,234560,210368
3274,209536,25024,896,234560,210432
3275,209600,24960,896,234560,210496
3276,209664,24896,896,234560,210560
3277,209728,24832,896,234560,210624
3278,209792,24768,896,234560,210688
3279,209856,24704,896,234560,210752
3280,209920,24640,896,234560,210816
3281,209984,24576,896,234560,210880
3282,210048,24512,896,234560,210944
3283,210112,24448,896,234560,211008
3284,210176,24384,896,234560,211072
3285,210240,24320,896,234560,211136
3286,210304,24256,896,234560,211200
3287,210368,24192,896,234560,211264
3288,210432,24128,896,234560,211328
3289,210496,24064,896,234560,211392
3290,210560,24000,896,234560,211456
3291,210624,23936,896,234560,211520
3292,210688,23872,896,234560,211584
3293,210752,23808,896,234560,211648
3294,210816,23744,896,234560,211712
3295,210880,23680,896,234560,211776
3296,210944,23616,896,234560,211840
3297,211008,23552,896,234560,211904
3298,211072,23488,896,234560,211968
3299,211136,23424,896,234560,212032
3300,211200,23360,896,234560,212096
3301,211264,23296,896,234560,212160
3302,211328,23232,896,234560,212224
3303,211392,23168,896,234560,212288
3304,211456,23104,896,234560,212352
3305,211520,23040,896,234560,212416
3306,211584,22976,896,234560,212480
3307,211648,22912,896,234560,212544
3308,211712,22848,896,234560,212608
3309,211776,22784,896,234560,212672
3310,211840,22720,896,234560,212736
3311,211904,22656,896,234560,212800
3312,211968,22592,896,234560,212864
3313,212032,22528,896,234560,212928
3314,212096,22464,896,234560,212992
3315,212160,22400,896,234560,213056
3316,212224,22336,896,234560,213120
3317,212288,22272,896,234560,213184
3318,212352,22208,896,234560,213248
3319,212416,22144,896,234560,213312
3320,212480,22080,896,234560,213376
3321,212544,22016,896,234560,213440
3322,212608,21952,896,234560,213504
3323,212672,21888,896,234560,213568
3324,212736,21824,896,234560,213632
3325,212800,21760,896,234560,213696
3326,212864,21696,896,234560,213760
3327,212928,21632,896,234560,213824
3328,212992,21568,896,234560,213888
3329,213056,21504,896,234560,213952
3330,213120,21440,896,234560,214016
3331,213184,21376,896,234560,214080
3332,213248,21312,896,234560,214144
3333,213312,21248,896,234560,214208
3334,213376,21184,896,234560,214272
3335,213440,21120,896,234560,214336
3336,213504,21056,896,234560,214400
3337,213568,20992,896,234560,214464
3338,213632,20928,896,234560,214528
3339,213696,20864,896,234560,214592
3340,213760,20800,896,234560,214656
3341,213824,20736,896,234560,214720
3342,213888,20672,896,234560,214784
3343,213952,20608,896,234560,214848
3344,214016,20544,896,234560,214912
3345,214080,20480,896,234560,214976
3346,214144,20416,896,234560,215040
3347,214208,20352,896,234560,215104
3348,214272,20288,896,234560,215168
3349,214336,20224,896,234560,215232
3350,214400,20160,896,234560,215296
3351,214464,20096,896,234560,215360
3352,214528,20032,896,234560,215424
3353,214592,19968,896,234560,215488
3354,214656,19904,896,234560,215552
3355,214720,19840,896,234560,215616
3356,214784,19776,896,234560,215680
3357,214848,19712,896,234560,215744
3358,214912,19648,896,234560,215808
3359,214976,19584,896,234560,215872
3360,215040,19520,896,234560,215936
3361,215104,19456,896,234560,216000
3362,215168,19392,896,234560,216064
3363,215232,19328,896,234560,216128
3364,215296,19264,896,234560,216192
3365,215360,19200,896,234560,216256
3366,215424,19136,896,234560,216320
3367,215488,19072,896,234560,216384
3368,215552,19008,896,234560,216448
3369,215616,18944,896,234560,216512
3370,215680,18880,896,234560,216576
3371,215744,18816,896,234560,216640
3372,215808,18752,896,234560,216704
3373,215872,18688,896,234560,216768
3374,215936,18624,896,234560,216832
3375,216000,18560,896,234560,216896
3376,216064,18496,896,234560,216960
3377,216128,18432,896,234560,217024
3378,216192,18368,896,234560,217088
3379,216256,18304,896,234560,217152
3380,216320,18240,896,234560,217216
3381,216384,18176,896,234560,217280
3382,216448,18112,896,234560,217344
3383,216512,18048,896,234560,217408
3384,216576,17984,896,234560,217472
3385,216640,17920,896,234560,217536
3386,216704,17856,896,234560,217600
3387,216768,17792,896,234560,217664
3388,216832,17728,896,234560,217728
3389,216896,17664,896,234560,217792
3390,216960,17600,896,234560,217856
3391,217024,17536,896,234560,217920
3392,217088,17472,896,234560,217984
3393,217152,17408,896,234560,218048
3394,217216,17344,896,234560,218112
3395,217280,17280,896,234560,218176
3396,217344,17216,896,234560,218240
3397,217408,17152,896,234560,218304
3398,217472,17088,896,234560,218368
3399,217536,17024,896,234560,218432
3400,217600,16960,896,234560,218496
3401,217664,16896,896,234560,218560
3402,217728,16832,896,234560,218624
3403,217792,16768,896,234560,218688
3404,217856,16704,896,234560,218752
3405,217920,16640,896,234560,218816
3406,217984,16576,896,234560,218880
3407,218048,16512,896,234560,218944
3408,218112,16448,896,234560,219008
3409,218176,16384,896,234560,219072
3410,218240,16320,896,234560,219136
3411,218304,16256,896,234560,219200
3412,218368,16192,896,234560,219264
3413,218432,16128,896,234560,219328
3414,218496,16064,896,234560,219392
3415,218560,16000,896,234560,219456
3416,218624,15936,896,234560,219520
3417,218688,15872,896,234560,219584
3418,218752,15808,896,234560,219648
3419,218816,15744,896,234560,219712
3420,218880,15680,896,234560,219776
3421,218944,15616,896,234560,219840
3422,219008,15552,896,234560,219904
3423,219072,15488,896,234560,219968
3424,219136,15424,896,234560,220032
3425,219200,15360,896,234560,220096
3426,219264,15296,896,234560,220160
3427,219328,15232,896,234560,220224
3428,219392,15168,896,234560,220288
3429,219456,15104,896,234560,220352
3430,219520,15040,896,234560,220416
3431,219584,14976,896,234560,220480
3432,219648,14912,896,234560,220544
3433,219712,14848,896,234560,220608
3434,219776,14784,896,234560,220672
3435,219840,14720,896,234560,220736
3436,219904,14656,896,234560,220800
3437,219968,14592,896,234560,220864
3438,220032,14528,896,234560,220928
3439,220096,14464,896,234560,220992
3440,220160,14400,896,234560,221056
3441,220224,14336,896,234560,221120
3442,220288,14272,896,234560,221184
3443,220352,14208,896,234560,221248
3444,220416,14144,896,234560,221312
3445,220480,14080,896,234560,221376
3446,220544,14016,896,234560,221440
3447,220608,13952,896,234560,221504
3448,220672,13888,896,234560,221568
3449,220736,13824,896,234560,221632
3450,220800,13760,896,234560,221696
3451,220864,13696,896,234560,221760
3452,220928,13632,896,234560,221824
3453,220992,13568,896,234560,221888
3454,221056,13504,896,234560,221952
3455,221120,13440,896,234560,222016
3456,221184,13376,896,234560,222080
3457,221248,13312,896,234560,222144
3458,221312,13248,896,234560,222208
3459,221376,13184,896,234560,222272
3460,221440,13120,896,234560,222336
3461,221504,13056,896,234560,222400
3462,221568,12992,896,234560,222464
3463,221632,12928,896,234560,222528
3464,221696,12864,896,234560,222592
3465,221760,12800,896,234560,222656
3466,221824,12736,896,234560,222720
3467,221888,12672,896,234560,222784
3468,221952,12608,896,234560,222848
3469,222016,12544,896,234560,222912
3470,222080,12480,896,234560,222976
3471,222144,12416,896,234560,223040
3472,222208,12352,896,234560,223104
3473,222272,12288,896,234560,223168
3474,222336,12224,896,234560,223232
3475,222400,12160,896,234560,223296
3476,222464,12096,896,234560,223360
3477,222528,12032,896,234560,223424
3478,222592,11968,896,234560,223488
3479,222656,11904,896,234560,223552
3480,222720,11840,896,234560,223616
3481,222784,11776,896,234560,223680
3482,222848,11712,896,234560,223744
3483,222912,11648,896,234560,223808
3484,222976,11584,896,234560,223872
3485,223040,11520,896,234560,223936
3486,223104,11456,896,234560,224000
3487,223168,11392,896,234560,224064
3488,223232,11328,896,234560,224128
3489,223296,11264,896,234560,224192
3490,223360,11200,896,234560,224256
3491,223424,11136,896,234560,224320
3492,223488,11072,896,234560,224384
3493,223552,11008,896,234560,224448
3494,223616,10944,896,234560,224512
3495,223680,10880,896,234560,224576
3496,223744,10816,896,234560,224640
3497,223808,10752,896,234560,224704
3498,223872,10688,896,234560,224768
3499,223936,10624,896,234560,224832
3500,224000,10560,896,234560,224896
3501,224064,10496,896,234560,224960
3502,224128,10432,896,234560,225024
3503,224192,10368,896,234560,225088
3504,224256,10304,896,234560,225152
3505,224320,10240,896,234560,225216
3506,224384,10176,896,234560,225280
3507,224448,10112,896,234560,225344
3508,224512,10048,896,234560,225408
3509,224576,9984,896,234560,225472
3510,224640,9920,896,234560,225536
3511,224704,9856,896,234560,225600
3512,224768,9792,896,234560,225664
3513,224832,9728,896,234560,225728
3514,224896,9664,896,234560,225792
3515,224960,9600,896,234560,225856
3516,225024,9536,896,234560,225920
3517,225088,9472,896,234560,225984
3518,225152,9408,896,234560,226048
3519,225216,9344,896,234560,226112
3520,225280,9280,896,234560,226176
3521,225344,9216,896,234560,226240
3522,225408,9152,896,234560,226304
3523,225472,9088,896,234560,226368
3524,225536,9024,896,234560,226432
3525,225600,8960,896,234560,226496
3526,225664,8896,896,234560,226560
3527,225728,8832,896,234560,226624
3528,225792,8768,896,234560,226688
3529,225856,8704,896,234560,226752
3530,225920,8640,896,234560,226816
3531,225984,8576,896,234560,226880
3532,226048,8512,896,234560,226944
3533,226112,8448,896,234560,227008
3534,226176,8384,896,234560,227072
3535,226240,8320,896,234560,227136
3536,226304,8256,896,234560,227200
3537,226368,8192,896,234560,227264
3538,226432,8128,896,234560,227328
3539,226496,8064,896,234560,227392
3540,226560,8000,896,234560,227456
3541,226624,7936,896,234560,227520
3542,226688,7872,896,234560,227584
3543,226752,7808,896,234560,227648
3544,226816,7744,896,234560,227712
3545,226880,7680,896,234560,227776
3546,226944,7616,896,234560,227840
3547,227008,7552,896,234560,227904
3548,227072,7488,896,234560,227968
3549,227136,7424,896,234560,228032
3550,227200,7360,896,234560,228096
3551,227264,7296,896,234560,228160
3552,227328,7232,896,234560,228224
3553,227392,7168,896,234560,228288
3554,227456,7104,896,234560,228352
3555,227520,7040,896,234560,228416
3556,227584,6976,896,234560,228480
3557,227648,6912,896,234560,228544
3558,227712,6848,896,234560,228608
3559,227776,6784,896,234560,228672
3560,227840,6720,896,234560,228736
3561,227904,6656,896,234560,228800
3562,227968,6592,896,234560,228864
3563,228032,6528,896,234560,228928
3564,228096,6464,896,234560,228992
3565,228160,6400,896,234560,229056
3566,228224,6336,896,234560,229120
3567,228288,6272,896,234560,229184
3568,228352,6208,896,234560,229248
3569,228416,6144,896,234560,229312
3570,228480,6080,896,234560,229376
3571,228544,6016,896,234560,229440
3572,228608,5952,896,234560,229504
3573,228672,5888,896,234560,229568
3574,228736,5824,896,234560,229632
3575,228800,5760,896,234560,229696
3576,228864,5696,896,234560,229760
3577,228928,5632,896,234560,229824
3578,228992,5568,896,234560,229888
3579,229056,5504,896,234560,229952
3580,229120,5440,896,234560,230016
3581,229184,5376,896,234560,230080
3582,229248,5312,896,234560,230144
3583,229312,5248,896,234560,230208
3584,229376,5184,896,234560,230272
3585,229440,5120,896,234560,230336
3586,229504,5056,896,234560,230400
3587,229568,4992,896,234560,230464
3588,229632,4928,896,234560,230528
3589,229696,4864,896,234560,230592
3590,229760,4800,896,234560,230656
3591,229824,4736,896,234560,230720
3592,229888,4672,896,234560,230784
3593,229952,4608,896,234560,230848
3594,230016,4544,896,234560,230912
3595,230080,4480,896,234560,230976
3596,230144,4416,896,234560,231040
3597,230208,4352,896,234560,231104
3598,230272,4288,896,234560,231168
3599,230336,4224,896,234560,231232
3600,230400,4160,896,234560,231296
3601,230464,4096,896,234560,231360
3602,230528,4032,896,234560,231424
3603,230592,3968,896,234560,231488
3604,230656,3904,896,234560,231552
3605,230720,3840,896,234560,231616
3606,230784,3776,896,234560,231680
3607,230848,3712,896,234560,231744
3608,230912,3648,896,234560,231808
3609,230976,3584,896,234560,231872
3610,231040,3520,896,234560,231936
3611,231104,3456,896,234560,232000
3612,231168,3392,896,234560,232064
3613,231232,3328,896,234560,232128
3614,231296,3264,896,234560,232192
3615,231360,3200,896,234560,232256
3616,231424,3136,896,234560,232320
3617,231488,3072,896,234560,232384
3618,231552,3008,896,234560,232448
3619,231616,2944,896,234560,232512
3620,231680,2880,896,234560,232576
3621,231744,2816,896,234560,232640
3622,231808,2752,896,234560,232704
3623,231872,2688,896,234560,232768
3624,231936,2624,896,234560,232832
3625,232000,2560,896,234560,232896
3626,232064,2496,896,234560,232960
3627,232128,2432,896,234560,233024
3628,232192,2368,896,234560,233088
3629,232256,2304,896,234560,233152
3630,232320,2240,896,234560,233216
3631,232384,2176,896,234560,233280
3632,232448,2112,896,234560,233344
3633,232512,2048,896,234560,233408
3634,232576,1984,896,234560,233472
3635,232640,1920,896,234560,233536
3636,232704,1856,896,234560,233600
3637,232768,1792,896,234560,233664
3638,232832,1728,896,234560,233728
3639,232896,1664,896,234560,233792
3640,232960,1600,896,234560,233856
3641,233024,1536,896,234560,233920
3642,233088,1472,896,234560,233984
3643,233152,1408,896,234560,234048
3644,233216,1344,896,234560,234112
3645,233280,1280,896,234560,234176
3646,233344,1216,896,234560,234240
3647,233408,1152,896,234560,234304
3648,233472,1088,896,234560,234368
3649,233536,1024,896,234560,234432
3650,233600,960,896,234560,234496
3651,233664,896,896,234560,234560
3652,233728,832,896,234560,234624
3653,233792,768,896,234560,234688
3654,233856,704,896,234560,234752
3655,233920,640,896,234560,234816
3656,233984,576,896,234560,234880
3657,234048,512,896,234560,234944
3658,234112,448,896,234560,235008
3659,234176,384,896,234560,235072
3660,234240,320,896,234560,235136
3661,234304,29952,896,264256,235200
3662,234368,29888,896,264256,235264
3663,234432,29824,896,264256,235328
3664,234496,29760,896,264256,235392
3665,234560,29696,896,264256,235456
3666,234624,29632,896,264256,235520
3667,234688,29568,896,264256,235584
3668,234752,29504,896,264256,235648
3669,234816,29440,896,264256,235712
3670,234880,29376,896,264256,235776
3671,234944,29312,896,264256,235840
3672,235008,29248,896,264256,235904
3673,235072,29184,896,264256,235968
3674,235136,29120,896,264256,236032
3675,235200,29056,896,264256,236096
3676,235264,28992,896,264256,236160
3677,235328,28928,896,264256,236224
3678,235392,28864,896,264256,236288
3679,235456,28800,896,264256,236352
3680,235520,28736,896,264256,236416
3681,235584,28672,896,264256,236480
3682,235648,28608,896,264256,236544
3683,235712,28544,896,264256,236608
3684,235776,28480,896,264256,236672
3685,235840,28416,896,264256,236736
3686,235904,28352,896,264256,236800
3687,235968,28288,896,264256,236864
3688,236032,28224,896,264256,236928
3689,236096,28160,896,264256,236992
3690,236160,28096,896,264256,237056
3691,236224,28032,896,264256,237120
3692,236288,27968,896,264256,237184
3693,236352,27904,896,264256,237248
3694,236416,27840,896,264256,237312
3695,236480,27776,896,264256,237376
3696,236544,27712,896,264256,237440
3697,236608,27648,896,264256,237504
3698,236672,27584,896,264256,237568
3699,236736,27520,896,264256,237632
3700,236800,27456,896,264256,237696
3701,236864,27392,896,264256,237760
3702,236928,27328,896,264256,237824
3703,236992,27264,896,264256,237888
3704,237056,27200,896,264256,237952
3705,237120,27136,896,264256,238016
3706,237184,27072,896,264256,238080
3707,237248,27008,896,264256,238144
3708,237312,26944,896,264256,238208
3709,237376,26880,896,264256,238272
3710,237440,26816,896,264256,238336
3711,237504,26752,896,264256,238400
3712,237568,26688,896,264256,238464
3713,237632,26624,896,264256,238528
3714,237696,26560,896,264256,238592
3715,237760,26496,896,264256,238656
3716,237824,26432,896,264256,238720
3717,237888,26368,896,264256,238784
3718,237952,26304,896,264256,238848
3719,238016,26240,896,264256,238912
3720,238080,26176,896,264256,238976
3721,238144,26112,896,264256,239040
3722,238208,26048,896,264256,239104
3723,238272,25984,896,264256,239168
3724,238336,25920,896,264256,239232
3725,238400,25856,896,264256,239296
3726,238464,25792,896,264256,239360
3727,238528,25728,896,264256,239424
3728,238592,25664,896,264256,239488
3729,238656,25600,896,264256,239552
3730,238720,25536,896,264256,239616
3731,238784,25472,896,264256,239680
3732,238848,25408,896,264256,239744
3733,238912,25344,896,264256,239808
3734,238976,25280,896,264256,239872
3735,239040,25216,896,264256,239936
3736,239104,25152,896,264256,240000
3737,239168,25088,896,264256,240064
3738,239232,25024,896,264256,240128
3739,239296,24960,896,264256,240192
3740,239360,24896,896,264256,240256
3741,239424,24832,896,264256,240320
3742,239488,24768,896,264256,240384
3743,239552,24704,896,264256,240448
3744,239616,24640,896,264256,240512
3745,239680,24576,896,264256,240576
3746,239744,24512,896,264256,240640
3747,239808,24448,896,264256,240704
3748,239872,24384,896,264256,240768
3749,239936,24320,896,264256,240832
3750,240000,24256,896,264256,240896
3751,240064,24192,896,264256,240960
3752,240128,24128,896,264256,241024
3753,240192,24064,896,264256,241088
3754,240256,24000,896,264256,241152
3755,240320,23936,896,264256,241216
3756,240384,23872,896,264256,241280
3757,240448,23808,896,264256,241344
3758,240512,23744,896,264256,241408
3759,240576,23680,896,264256,241472
3760,240640,23616,896,264256,241536
3761,240704,23552,896,264256,241600
3762,240768,23488,896,264256,241664
3763,240832,23424,896,264256,241728
3764,240896,23360,896,264256,241792
3765,240960,23296,896,264256,241856
3766,241024,23232,896,264256,241920
3767,241088,23168,896,264256,241984
3768,241152,23104,896,264256,242048
3769,241216,23040,896,264256,242112
3770,241280,22976,896,264256,242176
3771,241344,22912,896,264256,242240
3772,241408,22848,896,264256,242304
3773,241472,22784,896,264256,242368
3774,241536,22720,896,264256,242432
3775,241600,22656,896,264256,242496
3776,241664,22592,896,264256,242560
3777,241728,22528,896,264256,242624
3778,241792,22464,896,264256,242688
3779,241856,22400,896,264256,242752
3780,241920,22336,896,264256,242816
3781,241984,22272,896,264256,242880
3782,242048,22208,896,264256,242944
3783,242112,22144,896,264256,243008
3784,242176,22080,896,264256,243072
3785,242240,22016,896,264256,243136
3786,242304,21952,896,264256,243200
3787,242368,21888,896,264256,243264
3788,242432,21824,896,264256,243328
3789,242496,21760,896,264256,243392
3790,242560,21696,896,264256,243456
3791,242624,21632,896,264256,243520
3792,242688,21568,896,264256,243584
3793,242752,21504,896,264256,243648
3794,242816,21440,896,264256,243712
3795,242880,21376,896,264256,243776
3796,242944,21312,896,264256,243840
3797,243008,21248,896,264256,243904
3798,243072,21184,896,264256,243968
3799,243136,21120,896,264256,244032
3800,243200,21056,896,264256,244096
3801,243264,20992,896,264256,244160
3802,243328,20928,896,264256,244224
3803,243392,20864,896,264256,244288
3804,243456,20800,896,264256,244352
3805,243520,20736,896,264256,244416
3806,243584,20672,896,264256,244480
3807,243648,20608,896,264256,244544
3808,243712,20544,896,264256,244608
3809,243776,20480,896,264256,244672
3810,243840,20416,896,264256,244736
3811,243904,20352,896,264256,244800
3812,243968,20288,896,264256,244864
3813,244032,20224,896,264256,244928
3814,244096,20160,896,264256,244992
3815,244160,20096,896,264256,245056
3816,244224,20032,896,264256,245120
3817,244288,19968,896,264256,245184
3818,244352,19904,896,264256,245248
3819,244416,19840,896,264256,245312
3820,244480,19776,896,264256,245376
3821,244544,19712,896,264256,245440
3822,244608,19648,896,264256,245504
3823,244672,19584,896,264256,245568
3824,244736,19520,896,264256,245632
3825,244800,19456,896,264256,245696
3826,244864,19392,896,264256,245760
3827,244928,19328,896,264256,245824
3828,244992,19264,896,264256,245888
3829,245056,19200,896,264256,245952
3830,245120,19136,896,264256,246016
3831,245184,19072,896,264256,246080
3832,245248,19008,896,264256,246144
3833,245312,18944,896,264256,246208
3834,245376,18880,896,264256,246272
3835,245440,18816,896,264256,246336
3836,245504,18752,896,264256,246400
3837,245568,18688,896,264256,246464
3838,245632,18624,896,264256,246528
3839,245696,18560,896,264256,246592
3840,245760,18496,896,264256,246656
3841,245824,18432,896,264256,246720
3842,245888,18368,896,264256,246784
3843,245952,18304,896,264256,246848
3844,246016,18240,896,264256,246912
3845,246080,18176,896,264256,246976
3846,246144,18112,896,264256,247040
3847,246208,18048,896,264256,247104
3848,246272,17984,896,264256,247168
3849,246336,17920,896,264256,247232
3850,246400,17856,896,264256,247296
3851,246464,17792,896,264256,247360
3852,246528,17728,896,264256,247424
3853,246592,17664,896,264256,247488
3854,246656,17600,896,264256,247552
3855,246720,17536,896,264256,247616
3856,246784,17472,896,264256,247680
3857,246848,17408,896,264256,247744
3858,246912,17344,896,264256,247808
3859,246976,17280,896,264256,247872
3860,247040,17216,896,264256,247936
3861,247104,17152,896,264256,248000
3862,247168,17088,896,264256,248064
3863,247232,17024,896,264256,248128
3864,247296,16960,896,264256,248192
3865,247360,16896,896,264256,248256
3866,247424,16832,896,264256,248320
3867,247488,16768,896,264256,248384
3868,247552,16704,896,264256,248448
3869,247616,16640,896,264256,248512
3870,247680,16576,896,264256,248576
3871,247744,16512,896,264256,248640
3872,247808,16448,896,264256,248704
3873,247872,16384,896,264256,248768
3874,247936,16320,896,264256,248832
3875,248000,16256,896,264256,248896
3876,248064,16192,896,264256,248960
3877,248128,16128,896,264256,249024
3878,248192,16064,896,264256,249088
3879,248256,16000,896,264256,249152
3880,248320,15936,896,264256,249216
3881,248384,15872,896,264256,249280
3882,248448,15808,896,264256,249344
3883,248512,15744,896,264256,249408
3884,248576,15680,896,264256,249472
3885,248640,15616,896,264256,249536
3886,248704,15552,896,264256,249600
3887,248768,15488,896,264256,249664
3888,248832,15424,896,264256,249728
3889,248896,15360,896,264256,249792
3890,248960,15296,896,264256,249856
3891,249024,15232,896,264256,249920
3892,249088,15168,896,264256,249984
3893,249152,15104,896,264256,250048
3894,249216,15040,896,264256,250112
3895,249280,14976,896,264256,250176
3896,249344,14912,896,264256,250240
3897,249408,14848,896,264256,250304
3898,249472,14784,896,264256,250368
3899,249536,14720,896,264256,250432
3900,249600,14656,896,264256,250496
3901,249664,14592,896,264256,250560
3902,249728,14528,896,264256,250624
3903,249792,14464,896,264256,250688
3904,249856,14400,896,264256,250752
3905,249920,14336,896,264256,250816
3906,249984,14272,896,264256,250880
3907,250048,14208,896,264256,250944
3908,250112,14144,896,264256,251008
3909,250176,14080,896,264256,251072
3910,250240,14016,896,264256,251136
3911,250304,13952,896,264256,251200
3912,250368,13888,896,264256,251264
3913,250432,13824,896,264256,251328
3914,250496,13760,896,264256,251392
3915,250560,13696,896,264256,251456
3916,250624,13632,896,264256,251520
3917,250688,13568,896,264256,251584
3918,250752,13504,896,264256,251648
3919,250816,13440,896,264256,251712
3920,250880,13376,896,264256,251776
3921,250944,13312,896,264256,251840
3922,251008,13248,896,264256,251904
3923,251072,13184,896,264256,251968
3924,251136,13120,896,264256,252032
3925,251200,13056,896,264256,252096
3926,251264,12992,896,264256,252160
3927,251328,12928,896,264256,252224
3928,251392,12864,896,264256,252288
3929,251456,12800,896,264256,252352
3930,251520,12736,896,264256,252416
3931,251584,12672,896,264256,252480
3932,251648,12608,896,264256,252544
3933,251712,12544,896,264256,252608
3934,251776,12480,896,264256,252672
3935,251840,12416,896,264256,252736
3936,251904,12352,896,264256,252800
3937,251968,12288,896,264256,252864
3938,252032,12224,896,264256,252928
3939,252096,12160,896,264256,252992
3940,252160,12096,896,264256,253056
3941,252224,12032,896,264256,253120
3942,252288,11968,896,264256,253184
3943,252352,11904,896,264256,253248
3944,252416,11840,896,264256,253312
3945,252480,11776,896,264256,253376
3946,252544,11712,896,264256,253440
3947,252608,11648,896,264256,253504
3948,252672,11584,896,264256,253568
3949,252736,11520,896,264256,253632
3950,252800,11456,896,264256,253696
3951,252864,11392,896,264256,253760
3952,252928,11328,896,264256,253824
3953,252992,11264,896,264256,253888
3954,253056,11200,896,264256,253952
3955,253120,11136,896,264256,254016
3956,253184,11072,896,264256,254080
3957,253248,11008,896,264256,254144
3958,253312,10944,896,264256,254208
3959,253376,10880,896,264256,254272
3960,253440,10816,896,264256,254336
3961,253504,10752,896,264256,254400
3962,253568,10688,896,264256,254464
3963,253632,10624,896,264256,254528
3964,253696,10560,896,264256,254592
3965,253760,10496,896,264256,254656
3966,253824,10432,896,264256,254720
3967,253888,10368,896,264256,254784
3968,253952,10304,896,264256,254848
3969,254016,10240,896,264256,254912
3970,254080,10176,896,264256,254976
3971,254144,10112,896,264256,255040
3972,254208,10048,896,264256,255104
3973,254272,9984,896,264256,255168
3974,254336,9920,896,264256,255232
3975,254400,9856,896,264256,255296
3976,254464,9792,896,264256,255360
3977,254528,9728,896,264256,255424
3978,254592,9664,896,264256,255488
3979,254656,9600,896,264256,255552
3980,254720,9536,896,264256,255616
3981,254784,9472,896,264256,255680
3982,254848,9408,896,264256,255744
3983,254912,9344,896,264256,255808
3984,254976,9280,896,264256,255872
3985,255040,9216,896,264256,255936
3986,255104,9152,896,264256,256000
3987,255168,9088,896,264256,256064
3988,255232,9024,896,264256,256128
3989,255296,8960,896,264256,256192
3990,255360,8896,896,264256,256256
3991,255424,8832,896,264256,256320
3992,255488,8768,896,264256,256384
3993,255552,8704,896,264256,256448
3994,255616,8640,896,264256,256512
3995,255680,8576,896,264256,256576
3996,255744,8512,896,264256,256640
3997,255808,8448,896,264256,256704
3998,255872,8384,896,264256,256768
3999,255936,8320,896,264256,256832
4000,256000,8256,896,264256,256896
4001,256064,8192,896,264256,256960
4002,256128,8128,896,264256,257024
4003,256192,8064,896,264256,257088
4004,256256,8000,896,264256,257152
4005,256320,7936,896,264256,257216
4006,256384,7872,896,264256,257280
4007,256448,7808,896,264256,257344
4008,256512,7744,896,264256,257408
4009,256576,7680,896,264256,257472
4010,256640,7616,896,264256,257536
4011,256704,7552,896,264256,257600
4012,256768,7488,896,264256,257664
4013,256832,7424,896,264256,257728
4014,256896,7360,896,264256,257792
4015,256960,7296,896,264256,257856
4016,257024,7232,896,264256,257920
4017,257088,7168,896,264256,257984
4018,257152,7104,896,264256,258048
4019,257216,7040,896,264256,258112
4020,257280,6976,896,264256,258176
4021,257344,6912,896,264256,258240
4022,257408,6848,896,264256,258304
4023,257472,6784,896,264256,258368
4024,257536,6720,896,264256,258432
4025,257600,6656,896,264256,258496
4026,257664,6592,896,264256,258560
4027,257728,6528,896,264256,258624
4028,257792,6464,896,264256,258688
4029,257856,6400,896,264256,258752
4030,257920,6336,896,264256,258816
4031,257984,6272,896,264256,258880
4032,258048,6208,896,264256,258944
4033,258112,6144,896,264256,259008
4034,258176,6080,896,264256,259072
4035,258240,6016,896,264256,259136
4036,258304,5952,896,264256,259200
4037,258368,5888,896,264256,259264
4038,258432,5824,896,264256,259328
4039,258496,5760,896,264256,259392
4040,258560,5696,896,264256,259456
4041,258624,5632,896,264256,259520
4042,258688,5568,896,264256,259584
4043,258752,5504,896,264256,259648
4044,258816,5440,896,264256,259712
4045,258880,5376,896,264256,259776
4046,258944,5312,896,264256,259840
4047,259008,5248,896,264256,259904
4048,259072,5184,896,264256,259968
4049,259136,5120,896,264256,260032
4050,259200,5056,896,264256,260096
4051,259264,4992,896,264256,260160
4052,259328,4928,896,264256,260224
4053,259392,4864,896,264256,260288
4054,259456,4800,896,264256,260352
4055,259520,4736,896,264256,260416
4056,259584,4672,896,264256,260480
4057,259648,4608,896,264256,260544
4058,259712,4544,896,264256,260608
4059,259776,4480,896,264256,260672
4060,259840,4416,896,264256,260736
4061,259904,4352,896,264256,260800
4062,259968,4288,896,264256,260864
4063,260032,4224,896,264256,260928
4064,260096,4160,896,264256,260992
4065,260160,4096,896,264256,261056
4066,260224,4032,896,264256,261120
4067,260288,3968,896,264256,261184
4068,260352,3904,896,264256,261248
4069,260416,3840,896,264256,261312
4070,260480,3776,896,264256,261376
4071,260544,3712,896,264256,261440
4072,260608,3648,896,264256,261504
4073,260672,3584,896,264256,261568
4074,260736,3520,896,264256,261632
4075,260800,3456,896,264256,261696
4076,260864,3392,896,264256,261760
4077,260928,3328,896,264256,261824
4078,260992,3264,896,264256,261888
4079,261056,3200,896,264256,261952
4080,261120,3136,896,264256,262016
4081,261184,3072,896,264256,262080
4082,261248,3008,896,264256,262144
4083,261312,2944,896,264256,262208
4084,261376,2880,896,264256,262272
4085,261440,2816,896,264256,262336
4086,261504,2752,896,264256,262400
4087,261568,2688,896,264256,262464
4088,261632,2624,896,264256,262528
4089,261696,2560,896,264256,262592
4090,261760,2496,896,264256,262656
4091,261824,2432,896,264256,262720
4092,261888,2368,896,264256,262784
4093,261952,2304,896,264256,262848
4094,262016,2240,896,264256,262912
4095,262080,2176,896,264256,262976
4096,262144,2112,896,264256,263040
4097,262208,2048,896,264256,263104
4098,262272,1984,896,264256,263168
4099,262336,1920,896,264256,263232
4100,262400,1856,896,264256,263296
4101,262464,1792,896,264256,263360
4102,262528,1728,896,264256,263424
4103,262592,1664,896,264256,263488
4104,262656,1600,896,264256,263552
4105,262720,1536,896,264256,263616
4106,262784,1472,896,264256,263680
4107,262848,1408,896,264256,263744
4108,262912,1344,896,264256,263808
4109,262976,1280,896,264256,263872
4110,263040,1216,896,264256,263936
4111,263104,1152,896,264256,264000
4112,263168,1088,896,264256,264064
4113,263232,1024,896,264256,264128
4114,263296,960,896,264256,264192
4115,263360,896,896,264256,264256
4116,263424,832,896,264256,264320
4117,263488,768,896,264256,264384
4118,263552,704,896,264256,264448
4119,263616,640,896,264256,264512
4120,263680,576,896,264256,264576
4121,263744,512,896,264256,264640
4122,263808,448,896,264256,264704
4123,263872,384,896,264256,264768
4124,263936,320,896,264256,264832
4125,264000,33536,896,297536,264896
4126,264064,33472,896,297536,264960
4127,264128,33408,896,297536,265024
4128,264192,33344,896,297536,265088
4129,264256,33280,896,297536,265152
4130,264320,33216,896,297536,265216
4131,264384,33152,896,297536,265280
4132,264448,33088,896,297536,265344
4133,264512,33024,896,297536,265408
4134,264576,32960,896,297536,265472
4135,264640,32896,896,297536,265536
4136,264704,32832,896,297536,265600
4137,264768,32768,896,297536,265664
4138,264832,32704,896,297536,265728
4139,264896,32640,896,297536,265792
4140,264960,32576,896,297536,265856
4141,265024,32512,896,297536,265920
4142,265088,32448,896,297536,265984
4143,265152,32384,896,297536,266048
4144,265216,32320,896,297536,266112
4145,265280,32256,896,297536,266176
4146,265344,32192,896,297536,266240
4147,265408,32128,896,297536,266304
4148,265472,32064,896,297536,266368
4149,265536,32000,896,297536,266432
4150,265600,31936,896,297536,266496
4151,265664,31872,896,297536,266560
4152,265728,31808,896,297536,266624
4153,265792,31744,896,297536,266688
4154,265856,31680,896,297536,266752
4155,265920,31616,896,297536,266816
4156,265984,31552,896,297536,266880
4157,266048,31488,896,297536,266944
4158,266112,31424,896,297536,267008
4159,266176,31360,896,297536,267072
4160,266240,31296,896,297536,267136
4161,266304,31232,896,297536,267200
4162,266368,31168,896,297536,267264
4163,266432,31104,896,297536,267328
4164,266496,31040,896,297536,267392
4165,266560,30976,896,297536,267456
4166,266624,30912,896,297536,267520
4167,266688,30848,896,297536,267584
4168,266752,30784,896,297536,267648
4169,266816,30720,896,297536,267712
4170,266880,30656,896,297536,267776
4171,266944,30592,896,297536,267840
4172,267008,30528,896,297536,267904
4173,267072,30464,896,297536,267968
4174,267136,30400,896,297536,268032
4175,267200,30336,896,297536,268096
4176,267264,30272,896,297536,268160
4177,267328,30208,896,297536,268224
4178,267392,30144,896,297536,268288
4179,267456,30080,896,297536,268352
4180,267520,30016,896,297536,268416
4181,267584,29952,896,297536,268480
4182,267648,29888,896,297536,268544
4183,267712,29824,896,297536,268608
4184,267776,29760,896,297536,268672
4185,267840,29696,896,297536,268736
4186,267904,29632,896,297536,268800
4187,267968,29568,896,297536,268864
4188,268032,29504,896,297536,268928
4189,268096,29440,896,297536,268992
4190,268160,29376,896,297536,269056
4191,268224,29312,896,297536,269120
4192,268288,29248,896,297536,269184
4193,268352,29184,896,297536,269248
4194,268416,29120,896,297536,269312
4195,268480,29056,896,297536,269376
4196,268544,28992,896,297536,269440
4197,268608,28928,896,297536,269504
4198,268672,28864,896,297536,269568
4199,268736,28800,896,297536,269632
4200,268800,28736,896,297536,269696
4201,268864,28672,896,297536,269760
4202,268928,28608,896,297536,269824
4203,268992,28544,896,297536,269888
4204,269056,28480,896,297536,269952
4205,269120,28416,896,297536,270016
4206,269184,28352,896,297536,270080
4207,269248,28288,896,297536,270144
4208,269312,28224,896,297536,270208
4209,269376,28160,896,297536,270272
4210,269440,28096,896,297536,270336
4211,269504,28032,896,297536,270400
4212,269568,27968,896,297536,270464
4213,269632,27904,896,297536,270528
4214,269696,27840,896,297536,270592
4215,269760,27776,896,297536,270656
4216,269824,27712,896,297536,270720
4217,269888,27648,896,297536,270784
4218,269952,27584,896,297536,270848
4219,270016,27520,896,297536,270912
4220,270080,27456,896,297536,270976
4221,270144,27392,896,297536,271040
4222,270208,27328,896,297536,271104
4223,270272,27264,896,297536,271168
4224,270336,27200,896,297536,271232
4225,270400,27136,896,297536,271296
4226,270464,27072,896,297536,271360
4227,270528,27008,896,297536,271424
4228,270592,26944,896,297536,271488
4229,270656,26880,896,297536,271552
4230,270720,26816,896,297536,271616
4231,270784,26752,896,297536,271680
4232,270848,26688,896,297536,271744
4233,270912,26624,896,297536,271808
4234,270976,26560,896,297536,271872
4235,271040,26496,896,297536,271936
4236,271104,26432,896,297536,272000
4237,271168,26368,896,297536,272064
4238,271232,26304,896,297536,272128
4239,271296,26240,896,297536,272192
4240,271360,26176,896,297536,272256
4241,271424,26112,896,297536,272320
4242,271488,26048,896,297536,272384
4243,271552,25984,896,297536,272448
4244,271616,25920,896,297536,272512
4245,271680,25856,896,297536,272576
4246,271744,25792,896,297536,272640
4247,271808,25728,896,297536,272704
4248,271872,25664,896,297536,272768
4249,271936,25600,896,297536,272832
4250,272000,25536,896,297536,272896
4251,272064,25472,896,297536,272960
4252,272128,25408,896,297536,273024
4253,272192,25344,896,297536,273088
4254,272256,25280,896,297536,273152
4255,272320,25216,896,297536,273216
4256,272384,25152,896,297536,273280
4257,272448,25088,896,297536,273344
4258,272512,25024,896,297536,273408
4259,272576,24960,896,297536,273472
4260,272640,24896,896,297536,273536
4261,272704,24832,896,297536,273600
4262,272768,24768,896,297536,273664
4263,272832,24704,896,297536,273728
4264,272896,24640,896,297536,273792
4265,272960,24576,896,297536,273856
4266,273024,24512,896,297536,273920
4267,273088,24448,896,297536,273984
4268,273152,24384,896,297536,274048
4269,273216,24320,896,297536,274112
4270,273280,24256,896,297536,274176
4271,273344,24192,896,297536,274240
4272,273408,24128,896,297536,274304
4273,273472,24064,896,297536,274368
4274,273536,24000,896,297536,274432
4275,273600,23936,896,297536,274496
4276,273664,23872,896,297536,274560
4277,273728,23808,896,297536,274624
4278,273792,23744,896,297536,274688
4279,273856,23680,896,297536,274752
4280,273920,23616,896,297536,274816
4281,273984,23552,896,297536,274880
4282,274048,23488,896,297536,274944
4283,274112,23424,896,297536,275008
4284,274176,23360,896,297536,275072
4285,274240,23296,896,297536,275136
4286,274304,23232,896,297536,275200
4287,274368,23168,896,297536,275264
4288,274432,23104,896,297536,275328
4289,274496,23040,896,297536,275392
4290,274560,22976,896,297536,275456
4291,274624,22912,896,297536,275520
4292,274688,22848,896,297536,275584
4293,274752,22784,896,297536,275648
4294,274816,22720,896,297536,275712
4295,274880,22656,896,297536,275776
4296,274944,22592,896,297536,275840
4297,275008,22528,896,297536,275904
4298,275072,22464,896,297536,275968
4299,275136,22400,896,297536,276032
4300,275200,22336,896,297536,276096
4301,275264,22272,896,297536,276160
4302,275328,22208,896,297536,276224
4303,275392,22144,896,297536,276288
4304,275456,22080,896,297536,276352
4305,275520,22016,896,297536,276416
4306,275584,21952,896,297536,276480
4307,275648,21888,896,297536,276544
4308,275712,21824,896,297536,276608
4309,275776,21760,896,297536,276672
4310,275840,21696,896,297536,276736
4311,275904,21632,896,297536,276800
4312,275968,21568,896,297536,276864
4313,276032,21504,896,297536,276928
4314,276096,21440,896,297536,276992
4315,276160,21376,896,297536,277056
4316,276224,21312,896,297536,277120
4317,276288,21248,896,297536,277184
4318,276352,21184,896,297536,277248
4319,276416,21120,896,297536,277312
4320,276480,21056,896,297536,277376
4321,276544,20992,896,297536,277440
4322,276608,20928,896,297536,277504
4323,276672,20864,896,297536,277568
4324,276736,20800,896,297536,277632
4325,276800,20736,896,297536,277696
4326,276864,20672,896,297536,277760
4327,276928,20608,896,297536,277824
4328,276992,20544,896,297536,277888
4329,277056,20480,896,297536,277952
4330,277120,20416,896,297536,278016
4331,277184,20352,896,297536,278080
4332,277248,20288,896,297536,278144
4333,277312,20224,896,297536,278208
4334,277376,20160,896,297536,278272
4335,277440,20096,896,297536,278336
4336,277504,20032,896,297536,278400
4337,277568,19968,896,297536,278464
4338,277632,19904,896,297536,278528
4339,277696,19840,896,297536,278592
4340,277760,19776,896,297536,278656
4341,277824,19712,896,297536,278720
4342,277888,19648,896,297536,278784
4343,277952,19584,896,297536,278848
4344,278016,19520,896,297536,278912
4345,278080,19456,896,297536,278976
4346,278144,19392,896,297536,279040
4347,278208,19328,896,297536,279104
4348,278272,19264,896,297536,279168
4349,278336,19200,896,297536,279232
4350,278400,19136,896,297536,279296
4351,278464,19072,896,297536,279360
4352,278528,19008,896,297536,279424
4353,278592,18944,896,297536,279488
4354,278656,18880,896,297536,279552
4355,278720,18816,896,297536,279616
4356,278784,18752,896,297536,279680
4357,278848,18688,896,297536,279744
4358,278912,18624,896,297536,279808
4359,278976,18560,896,297536,279872
4360,279040,18496,896,297536,279936
4361,279104,18432,896,297536,280000
4362,279168,18368,896,297536,280064
4363,279232,18304,896,297536,280128
4364,279296,18240,896,297536,280192
4365,279360,18176,896,297536,280256
4366,279424,18112,896,297536,280320
4367,279488,18048,896,297536,280384
4368,279552,17984,896,297536,280448
4369,279616,17920,896,297536,280512
4370,279680,17856,896,297536,280576
4371,279744,17792,896,297536,280640
4372,279808,17728,896,297536,280704
4373,279872,17664,896,297536,280768
4374,279936,17600,896,297536,280832
4375,280000,17536,896,297536,280896
4376,280064,17472,896,297536,280960
4377,280128,17408,896,297536,281024
4378,280192,17344,896,297536,281088
4379,280256,17280,896,297536,281152
4380,280320,17216,896,297536,281216
4381,280384,17152,896,297536,281280
4382,280448,17088,896,297536,281344
4383,280512,17024,896,297536,281408
4384,280576,16960,896,297536,281472
4385,280640,16896,896,297536,281536
4386,280704,16832,896,297536,281600
4387,280768,16768,896,297536,281664
4388,280832,16704,896,297536,281728
4389,280896,16640,896,297536,281792
4390,280960,16576,896,297536,281856
4391,281024,16512,896,297536,281920
4392,281088,16448,896,297536,281984
4393,281152,16384,896,297536,282048
4394,281216,16320,896,297536,282112
4395,281280,16256,896,297536,282176
4396,281344,16192,896,297536,282240
4397,281408,16128,896,297536,282304
4398,281472,16064,896,297536,282368
4399,281536,16000,896,297536,282432
4400,281600,15936,896,297536,282496
4401,281664,15872,896,297536,282560
4402,281728,15808,896,297536,282624
4403,281792,15744,896,297536,282688
4404,281856,15680,896,297536,282752
4405,281920,15616,896,297536,282816
4406,281984,15552,896,297536,282880
4407,282048,15488,896,297536,282944
4408,282112,15424,896,297536,283008
4409,282176,15360,896,297536,283072
4410,282240,15296,896,297536,283136
4411,282304,15232,896,297536,283200
4412,282368,15168,896,297536,283264
4413,282432,15104,896,297536,283328
4414,282496,15040,896,297536,283392
4415,282560,14976,896,297536,283456
4416,282624,14912,896,297536,283520
4417,282688,14848,896,297536,283584
4418,282752,14784,896,297536,283648
4419,282816,14720,896,297536,283712
4420,282880,14656,896,297536,283776
4421,282944,14592,896,297536,283840
4422,283008,14528,896,297536,283904
4423,283072,14464,896,297536,283968
4424,283136,14400,896,297536,284032
4425,283200,14336,896,297536,284096
4426,283264,14272,896,297536,284160
4427,283328,14208,896,297536,284224
4428,283392,14144,896,297536,284288
4429,283456,14080,896,297536,284352
4430,283520,14016,896,297536,284416
4431,283584,13952,896,297536,284480
4432,283648,13888,896,297536,284544
4433,283712,13824,896,297536,284608
4434,283776,13760,896,297536,284672
4435,283840,13696,896,297536,284736
4436,283904,13632,896,297536,284800
4437,283968,13568,896,297536,284864
4438,284032,13504,896,297536,284928
4439,284096,13440,896,297536,284992
4440,284160,13376,896,297536,285056
4441,284224,13312,896,297536,285120
4442,284288,13248,896,297536,285184
4443,284352,13184,896,297536,285248
4444,284416,13120,896,297536,285312
4445,284480,13056,896,297536,285376
4446,284544,12992,896,297536,285440
4447,284608,12928,896,297536,285504
4448,284672,12864,896,297536,285568
4449,284736,12800,896,297536,285632
4450,284800,12736,896,297536,285696
4451,284864,12672,896,297536,285760
4452,284928,12608,896,297536,285824
4453,284992,12544,896,297536,285888
4454,285056,12480,896,297536,285952
4455,285120,12416,896,297536,286016
4456,285184,12352,896,297536,286080
4457,285248,12288,896,297536,286144
4458,285312,12224,896,297536,286208
4459,285376,12160,896,297536,286272
4460,285440,12096,896,297536,286336
4461,285504,12032,896,297536,286400
4462,285568,11968,896,297536,286464
4463,285632,11904,896,297536,286528
4464,285696,11840,896,297536,286592
4465,285760,11776,896,297536,286656
4466,285824,11712,896,297536,286720
4467,285888,11648,896,297536,286784
4468,285952,11584,896,297536,286848
4469,286016,11520,896,297536,286912
4470,286080,11456,896,297536,286976
4471,286144,11392,896,297536,287040
4472,286208,11328,896,297536,287104
4473,286272,11264,896,297536,287168
4474,286336,11200,896,297536,287232
4475,286400,11136,896,297536,287296
4476,286464,11072,896,297536,287360
4477,286528,11008,896,297536,287424
4478,286592,10944,896,297536,287488
4479,286656,10880,896,297536,287552
4480,286720,10816,896,297536,287616
4481,286784,10752,896,297536,287680
4482,286848,10688,896,297536,287744
4483,286912,10624,896,297536,287808
4484,286976,10560,896,297536,287872
4485,287040,10496,896,297536,287936
4486,287104,10432,896,297536,288000
4487,287168,10368,896,297536,288064
4488,287232,10304,896,297536,288128
4489,287296,10240,896,297536,288192
4490,287360,10176,896,297536,288256
4491,287424,10112,896,297536,288320
4492,287488,10048,896,297536,288384
4493,287552,9984,896,297536,288448
4494,287616,9920,896,297536,288512
4495,287680,9856,896,297536,288576
4496,287744,9792,896,297536,288640
4497,287808,9728,896,297536,288704
4498,287872,9664,896,297536,288768
4499,287936,9600,896,297536,288832
4500,288000,9536,896,297536,288896
4501,288064,9472,896,297536,288960
4502,288128,9408,896,297536,289024
4503,288192,9344,896,297536,289088
4504,288256,9280,896,297536,289152
4505,288320,9216,896,297536,289216
4506,288384,9152,896,297536,289280
4507,288448,9088,896,297536,289344
4508,288512,9024,896,297536,289408
4509,288576,8960,896,297536,289472
4510,288640,8896,896,297536,289536
4511,288704,8832,896,297536,289600
4512,288768,8768,896,297536,289664
4513,288832,8704,896,297536,289728
4514,288896,8640,896,297536,289792
4515,288960,8576,896,297536,289856
4516,289024,8512,896,297536,289920
4517,289088,8448,896,297536,289984
4518,289152,8384,896,297536,290048
4519,289216,8320,896,297536,290112
4520,289280,8256,896,297536,290176
4521,289344,8192,896,297536,290240
4522,289408,8128,896,297536,290304
4523,289472,8064,896,297536,290368
4524,289536,8000,896,297536,290432
4525,289600,7936,896,297536,290496
4526,289664,7872,896,297536,290560
4527,289728,7808,896,297536,290624
4528,289792,7744,896,297536,290688
4529,289856,7680,896,297536,290752
4530,289920,7616,896,297536,290816
4531,289984,7552,896,297536,290880
4532,290048,7488,896,297536,290944
4533,290112,7424,896,297536,291008
4534,290176,7360,896,297536,291072
4535,290240,7296,896,297536,291136
4536,290304,7232,896,297536,291200
4537,290368,7168,896,297536,291264
4538,290432,7104,896,297536,291328
4539,290496,7040,896,297536,291392
4540,290560,6976,896,297536,291456
4541,290624,6912,896,297536,291520
4542,290688,6848,896,297536,291584
4543,290752,6784,896,297536,291648
4544,290816,6720,896,297536,291712
4545,290880,6656,896,297536,291776
4546,290944,6592,896,297536,291840
4547,291008,6528,896,297536,291904
4548,291072,6464,896,297536,291968
4549,291136,6400,896,297536,292032
4550,291200,6336,896,297536,292096
4551,291264,6272,896,297536,292160
4552,291328,6208,896,297536,292224
4553,291392,6144,896,297536,292288
4554,291456,6080,896,297536,292352
4555,291520,6016,896,297536,292416
4556,291584,5952,896,297536,292480
4557,291648,5888,896,297536,292544
4558,291712,5824,896,297536,292608
4559,291776,5760,896,297536,292672
4560,291840,5696,896,297536,292736
4561,291904,5632,896,297536,292800
4562,291968,5568,896,297536,292864
4563,292032,5504,896,297536,292928
4564,292096,5440,896,297536,292992
4565,292160,5376,896,297536,293056
4566,292224,5312,896,297536,293120
4567,292288,5248,896,297536,293184
4568,292352,5184,896,297536,293248
4569,292416,5120,896,297536,293312
4570,292480,5056,896,297536,293376
4571,292544,4992,896,297536,293440
4572,292608,4928,896,297536,293504
4573,292672,4864,896,297536,293568
4574,292736,4800,896,297536,293632
4575,292800,4736,896,297536,293696
4576,292864,4672,896,297536,293760
4577,292928,4608,896,297536,293824
4578,292992,4544,896,297536,293888
4579,293056,4480,896,297536,293952
4580,293120,4416,896,297536,294016
4581,293184,4352,896,297536,294080
4582,293248,4288,896,297536,294144
4583,293312,4224,896,297536,294208
4584,293376,4160,896,297536,294272
4585,293440,4096,896,297536,294336
4586,293504,4032,896,297536,294400
4587,293568,3968,896,297536,294464
4588,293632,3904,896,297536,294528
4589,293696,3840,896,297536,294592
4590,293760,3776,896,297536,294656
4591,293824,3712,896,297536,294720
4592,293888,3648,896,297536,294784
4593,293952,3584,896,297536,294848
4594,294016,3520,896,297536,294912
4595,294080,3456,896,297536,294976
4596,294144,3392,896,297536,295040
4597,294208,3328,896,297536,295104
4598,294272,3264,896,297536,295168
4599,294336,3200,896,297536,295232
4600,294400,3136,896,297536,295296
4601,294464,3072,896,297536,295360
4602,294528,3008,896,297536,295424
4603,294592,2944,896,297536,295488
4604,294656,2880,896,297536,295552
4605,294720,2816,896,297536,295616
4606,294784,2752,896,297536,295680
4607,294848,2688,896,297536,295744
4608,294912,2624,896,297536,295808
4609,294976,2560,896,297536,295872
4610,295040,2496,896,297536,295936
4611,295104,2432,896,297536,296000
4612,295168,2368,896,297536,296064
4613,295232,2304,896,297536,296128
4614,295296,2240,896,297536,296192
4615,295360,2176,896,297536,296256
4616,295424,2112,896,297536,296320
4617,295488,2048,896,297536,296384
4618,295552,1984,896,297536,296448
4619,295616,1920,896,297536,296512
4620,295680,1856,896,297536,296576
4621,295744,1792,896,297536,296640
4622,295808,1728,896,297536,296704
4623,295872,1664,896,297536,296768
4624,295936,1600,896,297536,296832
4625,296000,1536,896,297536,296896
4626,296064,1472,896,297536,296960
4627,296128,1408,896,297536,297024
4628,296192,1344,896,297536,297088
4629,296256,1280,896,297536,297152
4630,296320,1216,896,297536,297216
4631,296384,1152,896,297536,297280
4632,296448,1088,896,297536,297344
4633,296512,1024,896,297536,297408
4634,296576,960,896,297536,297472
4635,296640,896,896,297536,297536
4636,296704,832,896,297536,297600
4637,296768,768,896,297536,297664
4638,296832,704,896,297536,297728
4639,296896,640,896,297536,297792
4640,296960,576,896,297536,297856
4641,297024,512,896,297536,297920
4642,297088,448,896,297536,297984
4643,297152,384,896,297536,298048
4644,297216,320,896,297536,298112
4645,297280,37632,896,334912,298176
4646,297344,37568,896,334912,298240
4647,297408,37504,896,334912,298304
4648,297472,37440,896,334912,298368
4649,297536,37376,896,334912,298432
4650,297600,37312,896,334912,298496
4651,297664,37248,896,334912,298560
4652,297728,37184,896,334912,298624
4653,297792,37120,896,334912,298688
4654,297856,37056,896,334912,298752
4655,297920,36992,896,334912,298816
4656,297984,36928,896,334912,298880
4657,298048,36864,896,334912,298944
4658,298112,36800,896,334912,299008
4659,298176,36736,896,334912,299072
4660,298240,36672,896,334912,299136
4661,298304,36608,896,334912,299200
4662,298368,36544,896,334912,299264
4663,298432,36480,896,334912,299328
4664,298496,36416,896,334912,299392
4665,298560,36352,896,334912,299456
4666,298624,36288,896,334912,299520
4667,298688,36224,896,334912,299584
4668,298752,36160,896,334912,299648
4669,298816,36096,896,334912,299712
4670,298880,36032,896,334912,299776
4671,298944,35968,896,334912,299840
4672,299008,35904,896,334912,299904
4673,299072,35840,896,334912,299968
4674,299136,35776,896,334912,300032
4675,299200,35712,896,334912,300096
4676,299264,35648,896,334912,300160
4677,299328,35584,896,334912,300224
4678,299392,35520,896,334912,300288
4679,299456,35456,896,334912,300352
4680,299520,35392,896,334912,300416
4681,299584,35328,896,334912,300480
4682,299648,35264,896,334912,300544
4683,299712,35200,896,334912,300608
4684,299776,35136,896,334912,300672
4685,299840,35072,896,334912,300736
4686,299904,35008,896,334912,300800
4687,299968,34944,896,334912,300864
4688,300032,34880,896,334912,300928
4689,300096,34816,896,334912,300992
4690,300160,34752,896,334912,301056
4691,300224,34688,896,334912,301120
4692,300288,34624,896,334912,301184
4693,300352,34560,896,334912,301248
4694,300416,34496,896,334912,301312
4695,300480,34432,896,334912,301376
4696,300544,34368,896,334912,301440
4697,300608,34304,896,334912,301504
4698,300672,34240,896,334912,301568
4699,300736,34176,896,334912,301632
4700,300800,34112,896,334912,301696
4701,300864,34048,896,334912,301760
4702,300928,33984,896,334912,301824
4703,300992,33920,896,334912,301888
4704,301056,33856,896,334912,301952
4705,301120,33792,896,334912,302016
4706,301184,33728,896,334912,302080
4707,301248,33664,896,334912,302144
4708,301312,33600,896,334912,302208
4709,301376,33536,896,334912,302272
4710,301440,33472,896,334912,302336
4711,301504,33408,896,334912,302400
4712,301568,33344,896,334912,302464
4713,301632,33280,896,334912,302528
4714,301696,33216,896,334912,302592
4715,301760,33152,896,334912,302656
4716,301824,33088,896,334912,302720
4717,301888,33024,896,334912,302784
4718,301952,32960,896,334912,302848
4719,302016,32896,896,334912,302912
4720,302080,32832,896,334912,302976
4721,302144,32768,896,334912,303040
4722,302208,32704,896,334912,303104
4723,302272,32640,896,334912,303168
4724,302336,32576,896,334912,303232
4725,302400,32512,896,334912,303296
4726,302464,32448,896,334912,303360
4727,302528,32384,896,334912,303424
4728,302592,32320,896,334912,303488
4729,302656,32256,896,334912,303552
4730,302720,32192,896,334912,303616
4731,302784,32128,896,334912,303680
4732,302848,32064,896,334912,303744
4733,302912,32000,896,334912,303808
4734,302976,31936,896,334912,303872
4735,303040,31872,896,334912,303936
4736,303104,31808,896,334912,304000
4737,303168,31744,896,334912,304064
4738,303232,31680,896,334912,304128
4739,303296,31616,896,334912,304192
4740,303360,31552,896,334912,304256
4741,303424,31488,896,334912,304320
4742,303488,31424,896,334912,304384
4743,303552,31360,896,334912,304448
4744,303616,31296,896,334912,304512
4745,303680,31232,896,334912,304576
4746,303744,31168,896,334912,304640
4747,303808,31104,896,334912,304704
4748,303872,31040,896,334912,304768
4749,303936,30976,896,334912,304832
4750,304000,30912,896,334912,304896
4751,304064,30848,896,334912,304960
4752,304128,30784,896,334912,305024
4753,304192,30720,896,334912,305088
4754,304256,30656,896,334912,305152
4755,304320,30592,896,334912,305216
4756,304384,30528,896,334912,305280
4757,304448,30464,896,334912,305344
4758,304512,30400,896,334912,305408
4759,304576,30336,896,334912,305472
4760,304640,30272,896,334912,305536
4761,304704,30208,896,334912,305600
4762,304768,30144,896,334912,305664
4763,304832,30080,896,334912,305728
4764,304896,30016,896,334912,305792
4765,304960,29952,896,334912,305856
4766,305024,29888,896,334912,305920
4767,305088,29824,896,334912,305984
4768,305152,29760,896,334912,306048
4769,305216,29696,896,334912,306112
4770,305280,29632,896,334912,306176
4771,305344,29568,896,334912,306240
4772,305408,29504,896,334912,306304
4773,305472,29440,896,334912,306368
4774,305536,29376,896,334912,306432
4775,305600,29312,896,334912,306496
4776,305664,29248,896,334912,306560
4777,305728,29184,896,334912,306624
4778,305792,29120,896,334912,306688
4779,305856,29056,896,334912,306752
4780,305920,28992,896,334912,306816
4781,305984,28928,896,334912,306880
4782,306048,28864,896,334912,306944
4783,306112,28800,896,334912,307008
4784,306176,28736,896,334912,307072
4785,306240,28672,896,334912,307136
4786,306304,28608,896,334912,307200
4787,306368,28544,896,334912,307264
4788,306432,28480,896,334912,307328
4789,306496,28416,896,334912,307392
4790,306560,28352,896,334912,307456
4791,306624,28288,896,334912,307520
4792,306688,28224,896,334912,307584
4793,306752,28160,896,334912,307648
4794,306816,28096,896,334912,307712
4795,306880,28032,896,334912,307776
4796,306944,27968,896,334912,307840
4797,307008,27904,896,334912,307904
4798,307072,27840,896,334912,307968
4799,307136,27776,896,334912,308032
4800,307200,27712,896,334912,308096
4801,307264,27648,896,334912,308160
4802,307328,27584,896,334912,308224
4803,307392,27520,896,334912,308288
4804,307456,27456,896,334912,308352
4805,307520,27392,896,334912,308416
4806,307584,27328,896,334912,308480
4807,307648,27264,896,334912,308544
4808,307712,27200,896,334912,308608
4809,307776,27136,896,334912,308672
4810,307840,27072,896,334912,308736
4811,307904,27008,896,334912,308800
4812,307968,26944,896,334912,308864
4813,308032,26880,896,334912,308928
4814,308096,26816,896,334912,308992
4815,308160,26752,896,334912,309056
4816,308224,26688,896,334912,309120
4817,308288,26624,896,334912,309184
4818,308352,26560,896,334912,309248
4819,308416,26496,896,334912,309312
4820,308480,26432,896,334912,309376
4821,308544,26368,896,334912,309440
4822,308608,26304,896,334912,309504
4823,308672,26240,896,334912,309568
4824,308736,26176,896,334912,309632
4825,308800,26112,896,334912,309696
4826,308864,26048,896,334912,309760
4827,308928,25984,896,334912,309824
4828,308992,25920,896,334912,309888
4829,309056,25856,896,334912,309952
4830,309120,25792,896,334912,310016
4831,309184,25728,896,334912,310080
4832,309248,25664,896,334912,310144
4833,309312,25600,896,334912,310208
4834,309376,25536,896,334912,310272
4835,309440,25472,896,334912,310336
4836,309504,25408,896,334912,310400
4837,309568,25344,896,334912,310464
4838,309632,25280,896,334912,310528
4839,309696,25216,896,334912,310592
4840,309760,25152,896,334912,310656
4841,309824,25088,896,334912,310720
4842,309888,25024,896,334912,310784
4843,309952,24960,896,334912,310848
4844,310016,24896,896,334912,310912
4845,310080,24832,896,334912,310976
4846,310144,24768,896,334912,311040
4847,310208,24704,896,334912,311104
4848,310272,24640,896,334912,311168
4849,310336,24576,896,334912,311232
4850,310400,24512,896,334912,311296
4851,310464,24448,896,334912,311360
4852,310528,24384,896,334912,311424
4853,310592,24320,896,334912,311488
4854,310656,24256,896,334912,311552
4855,310720,24192,896,334912,311616
4856,310784,24128,896,334912,311680
4857,310848,24064,896,334912,311744
4858,310912,24000,896,334912,311808
4859,310976,23936,896,334912,311872
4860,311040,23872,896,334912,311936
4861,311104,23808,896,334912,312000
4862,311168,23744,896,334912,312064
4863,311232,23680,896,334912,312128
4864,311296,23616,896,334912,312192
4865,311360,23552,896,334912,312256
4866,311424,23488,896,334912,312320
4867,311488,23424,896,334912,312384
4868,311552,23360,896,334912,312448
4869,311616,23296,896,334912,312512
4870,311680,23232,896,334912,312576
4871,311744,23168,896,334912,312640
4872,311808,23104,896,334912,312704
4873,311872,23040,896,334912,312768
4874,311936,22976,896,334912,312832
4875,312000,22912,896,334912,312896
4876,312064,22848,896,334912,312960
4877,312128,22784,896,334912,313024
4878,312192,22720,896,334912,313088
4879,312256,22656,896,334912,313152
4880,312320,22592,896,334912,313216
4881,312384,22528,896,334912,313280
4882,312448,22464,896,334912,313344
4883,312512,22400,896,334912,313408
4884,312576,22336,896,334912,313472
4885,312640,22272,896,334912,313536
4886,312704,22208,896,334912,313600
4887,312768,22144,896,334912,313664
4888,312832,22080,896,334912,313728
4889,312896,22016,896,334912,313792
4890,312960,21952,896,334912,313856
4891,313024,21888,896,334912,313920
4892,313088,21824,896,334912,313984
4893,313152,21760,896,334912,314048
4894,313216,21696,896,334912,314112
4895,313280,21632,896,334912,314176
4896,313344,21568,896,334912,314240
4897,313408,21504,896,334912,314304
4898,313472,21440,896,334912,314368
4899,313536,21376,896,334912,314432
4900,313600,21312,896,334912,314496
4901,313664,21248,896,334912,314560
4902,313728,21184,896,334912,314624
4903,313792,21120,896,334912,314688
4904,313856,21056,896,334912,314752
4905,313920,20992,896,334912,314816
4906,313984,20928,896,334912,314880
4907,314048,20864,896,334912,314944
4908,314112,20800,896,334912,315008
4909,314176,20736,896,334912,315072
4910,314240,20672,896,334912,315136
4911,314304,20608,896,334912,315200
4912,314368,20544,896,334912,315264
4913,314432,20480,896,334912,315328
4914,314496,20416,896,334912,315392
4915,314560,20352,896,334912,315456
4916,314624,20288,896,334912,315520
4917,314688,20224,896,334912,315584
4918,314752,20160,896,334912,315648
4919,314816,20096,896,334912,315712
4920,314880,20032,896,334912,315776
4921,314944,19968,896,334912,315840
4922,315008,19904,896,334912,315904
4923,315072,19840,896,334912,315968
4924,315136,19776,896,334912,316032
4925,315200,19712,896,334912,316096
4926,315264,19648,896,334912,316160
4927,315328,19584,896,334912,316224
4928,315392,19520,896,334912,316288
4929,315456,19456,896,334912,316352
4930,315520,19392,896,334912,316416
4931,315584,19328,896,334912,316480
4932,315648,19264,896,334912,316544
4933,315712,19200,896,334912,316608
4934,315776,19136,896,334912,316672
4935,315840,19072,896,334912,316736
4936,315904,19008,896,334912,316800
4937,315968,18944,896,334912,316864
4938,316032,18880,896,334912,316928
4939,316096,18816,896,334912,316992
4940,316160,18752,896,334912,317056
4941,316224,18688,896,334912,317120
4942,316288,18624,896,334912,317184
4943,316352,18560,896,334912,317248
4944,316416,18496,896,334912,317312
4945,316480,18432,896,334912,317376
4946,316544,18368,896,334912,317440
4947,316608,18304,896,334912,317504
4948,316672,18240,896,334912,317568
4949,316736,18176,896,334912,317632
4950,316800,18112,896,334912,317696
4951,316864,18048,896,334912,317760
4952,316928,17984,896,334912,317824
4953,316992,17920,896,334912,317888
4954,317056,17856,896,334912,317952
4955,317120,17792,896,334912,318016
4956,317184,17728,896,334912,318080
4957,317248,17664,896,334912,318144
4958,317312,17600,896,334912,318208
4959,317376,17536,896,334912,318272
4960,317440,17472,896,334912,318336
4961,317504,17408,896,334912,318400
4962,317568,17344,896,334912,318464
4963,317632,17280,896,334912,318528
4964,317696,17216,896,334912,318592
4965,317760,17152,896,334912,318656
4966,317824,17088,896,334912,318720
4967,317888,17024,896,334912,318784
4968,317952,16960,896,334912,318848
4969,318016,16896,896,334912,318912
4970,318080,16832,896,334912,318976
4971,318144,16768,896,334912,319040
4972,318208,16704,896,334912,319104
4973,318272,16640,896,334912,319168
4974,318336,16576,896,334912,319232
4975,318400,16512,896,334912,319296
4976,318464,16448,896,334912,319360
4977,318528,16384,896,334912,319424
4978,318592,16320,896,334912,319488
4979,318656,16256,896,334912,319552
4980,318720,16192,896,334912,319616
4981,318784,16128,896,334912,319680
4982,318848,16064,896,334912,319744
4983,318912,16000,896,334912,319808
4984,318976,15936,896,334912,319872
4985,319040,15872,896,334912,319936
4986,319104,15808,896,334912,320000
4987,319168,15744,896,334912,320064
4988,319232,15680,896,334912,320128
4989,319296,15616,896,334912,320192
4990,319360,15552,896,334912,320256
4991,319424,15488,896,334912,320320
4992,319488,15424,896,334912,320384
4993,319552,15360,896,334912,320448
4994,319616,15296,896,334912,320512
4995,319680,15232,896,334912,320576
4996,319744,15168,896,334912,320640
4997,319808,15104,896,334912,320704
4998,319872,15040,896,334912,320768
4999,319936,14976,896,334912,320832
5000,320000,14912,896,334912,320896
5001,320064,14848,896,334912,320960
5002,320128,14784,896,334912,321024
5003,320192,14720,896,334912,321088
5004,320256,14656,896,334912,321152
5005,320320,14592,896,334912,321216
5006,320384,14528,896,334912,321280
5007,320448,14464,896,334912,321344
5008,320512,14400,896,334912,321408
5009,320576,14336,896,334912,321472
5010,320640,14272,896,334912,321536
5011,320704,14208,896,334912,321600
5012,320768,14144,896,334912,321664
5013,320832,14080,896,334912,321728
5014,320896,14016,896,334912,321792
5015,320960,13952,896,334912,321856
5016,321024,13888,896,334912,321920
5017,321088,13824,896,334912,321984
5018,321152,13760,896,334912,322048
5019,321216,13696,896,334912,322112
5020,321280,13632,896,334912,322176
5021,321344,13568,896,334912,322240
5022,321408,13504,896,334912,322304
5023,321472,13440,896,334912,322368
5024,321536,13376,896,334912,322432
5025,321600,13312,896,334912,322496
5026,321664,13248,896,334912,322560
5027,321728,13184,896,334912,322624
5028,321792,13120,896,334912,322688
5029,321856,13056,896,334912,322752
5030,321920,12992,896,334912,322816
5031,321984,12928,896,334912,322880
5032,322048,12864,896,334912,322944
5033,322112,12800,896,334912,323008
5034,322176,12736,896,334912,323072
5035,322240,12672,896,334912,323136
5036,322304,12608,896,334912,323200
5037,322368,12544,896,334912,323264
5038,322432,12480,896,334912,323328
5039,322496,12416,896,334912,323392
5040,322560,12352,896,334912,323456
5041,322624,12288,896,334912,323520
5042,322688,12224,896,334912,323584
5043,322752,12160,896,334912,323648
5044,322816,12096,896,334912,323712
5045,322880,12032,896,334912,323776
5046,322944,11968,896,334912,323840
5047,323008,11904,896,334912,323904
5048,323072,11840,896,334912,323968
5049,323136,11776,896,334912,324032
5050,323200,11712,896,334912,324096
5051,323264,11648,896,334912,324160
5052,323328,11584,896,334912,324224
5053,323392,11520,896,334912,324288
5054,323456,11456,896,334912,324352
5055,323520,11392,896,334912,324416
5056,323584,11328,896,334912,324480
5057,323648,11264,896,334912,324544
5058,323712,11200,896,334912,324608
5059,323776,11136,896,334912,324672
5060,323840,11072,896,334912,324736
5061,323904,11008,896,334912,324800
5062,323968,10944,896,334912,324864
5063,324032,10880,896,334912,324928
5064,324096,10816,896,334912,324992
5065,324160,10752,896,334912,325056
5066,324224,10688,896,334912,325120
5067,324288,10624,896,334912,325184
5068,324352,10560,896,334912,325248
5069,324416,10496,896,334912,325312
5070,324480,10432,896,334912,325376
5071,324544,10368,896,334912,325440
5072,324608,10304,896,334912,325504
5073,324672,10240,896,334912,325568
5074,324736,10176,896,334912,325632
5075,324800,10112,896,334912,325696
5076,324864,10048,896,334912,325760
5077,324928,9984,896,334912,325824
5078,324992,9920,896,334912,325888
5079,325056,9856,896,334912,325952
5080,325120,9792,896,334912,326016
5081,325184,9728,896,334912,326080
5082,325248,9664,896,334912,326144
5083,325312,9600,896,334912,326208
5084,325376,9536,896,334912,326272
5085,325440,9472,896,334912,326336
5086,325504,9408,896,334912,326400
5087,325568,9344,896,334912,326464
5088,325632,9280,896,334912,326528
5089,325696,9216,896,334912,326592
5090,325760,9152,896,334912,326656
5091,325824,9088,896,334912,326720
5092,325888,9024,896,334912,326784
5093,325952,8960,896,334912,326848
5094,326016,8896,896,334912,326912
5095,326080,8832,896,334912,326976
5096,326144,8768,896,334912,327040
5097,326208,8704,896,334912,327104
5098,326272,8640,896,334912,327168
5099,326336,8576,896,334912,327232
5100,326400,8512,896,334912,327296
5101,326464,8448,896,334912,327360
5102,326528,8384,896,334912,327424
5103,326592,8320,896,334912,327488
5104,326656,8256,896,334912,327552
5105,326720,8192,896,334912,327616
5106,326784,8128,896,334912,327680
5107,326848,8064,896,334912,327744
5108,326912,8000,896,334912,327808
5109,326976,7936,896,334912,327872
5110,327040,7872,896,334912,327936
5111,327104,7808,896,334912,328000
5112,327168,7744,896,334912,328064
5113,327232,7680,896,334912,328128
5114,327296,7616,896,334912,328192
5115,327360,7552,896,334912,328256
5116,327424,7488,896,334912,328320
5117,327488,7424,896,334912,328384
5118,327552,7360,896,334912,328448
5119,327616,7296,896,334912,328512
5120,327680,7232,896,334912,328576
5121,327744,7168,896,334912,328640
5122,327808,7104,896,334912,328704
5123,327872,7040,896,334912,328768
5124,327936,6976,896,334912,328832
5125,328000,6912,896,334912,328896
5126,328064,6848,896,334912,328960
5127,328128,6784,896,334912,329024
5128,328192,6720,896,334912,329088
5129,328256,6656,896,334912,329152
5130,328320,6592,896,334912,329216
5131,328384,6528,896,334912,329280
5132,328448,6464,896,334912,329344
5133,328512,6400,896,334912,329408
5134,328576,6336,896,334912,329472
5135,328640,6272,896,334912,329536
5136,328704,6208,896,334912,329600
5137,328768,6144,896,334912,329664
5138,328832,6080,896,334912,329728
5139,328896,6016,896,334912,329792
5140,328960,5952,896,334912,329856
5141,329024,5888,896,334912,329920
5142,329088,5824,896,334912,329984
5143,329152,5760,896,334912,330048
5144,329216,5696,896,334912,330112
5145,329280,5632,896,334912,330176
5146,329344,5568,896,334912,330240
5147,329408,5504,896,334912,330304
5148,329472,5440,896,334912,330368
5149,329536,5376,896,334912,330432
5150,329600,5312,896,334912,330496
5151,329664,5248,896,334912,330560
5152,329728,5184,896,334912,330624
5153,329792,5120,896,334912,330688
5154,329856,5056,896,334912,330752
5155,329920,4992,896,334912,330816
5156,329984,4928,896,334912,330880
5157,330048,4864,896,334912,330944
5158,330112,4800,896,334912,331008
5159,330176,4736,896,334912,331072
5160,330240,4672,896,334912,331136
5161,330304,4608,896,334912,331200
5162,330368,4544,896,334912,331264
5163,330432,4480,896,334912,331328
5164,330496,4416,896,334912,331392
5165,330560,4352,896,334912,331456
5166,330624,4288,896,334912,331520
5167,330688,4224,896,334912,331584
5168,330752,4160,896,334912,331648
5169,330816,4096,896,334912,331712
5170,330880,4032,896,334912,331776
5171,330944,3968,896,334912,331840
5172,331008,3904,896,334912,331904
5173,331072,3840,896,334912,331968
5174,331136,3776,896,334912,332032
5175,331200,3712,896,334912,332096
5176,331264,3648,896,334912,332160
5177,331328,3584,896,334912,332224
5178,331392,3520,896,334912,332288
5179,331456,3456,896,334912,332352
5180,331520,3392,896,334912,332416
5181,331584,3328,896,334912,332480
5182,331648,3264,896,334912,332544
5183,331712,3200,896,334912,332608
5184,331776,3136,896,334912,332672
5185,331840,3072,896,334912,332736
5186,331904,3008,896,334912,332800
5187,331968,2944,896,334912,332864
5188,332032,2880,896,334912,332928
5189,332096,2816,896,334912,332992
5190,332160,2752,896,334912,333056
5191,332224,2688,896,334912,333120
5192,332288,2624,896,334912,333184
5193,332352,2560,896,334912,333248
5194,332416,2496,896,334912,333312
5195,332480,2432,896,334912,333376
5196,332544,2368,896,334912,333440
5197,332608,2304,896,334912,333504
5198,332672,2240,896,334912,333568
5199,332736,2176,896,334912,333632
5200,332800,2112,896,334912,333696
5201,332864,2048,896,334912,333760
5202,332928,1984,896,334912,333824
5203,332992,1920,896,334912,333888
5204,333056,1856,896,334912,333952
5205,333120,1792,896,334912,334016
5206,333184,1728,896,334912,334080
5207,333248,1664,896,334912,334144
5208,333312,1600,896,334912,334208
5209,333376,1536,896,334912,334272
5210,333440,1472,896,334912,334336
5211,333504,1408,896,334912,334400
5212,333568,1344,896,334912,334464
5213,333632,1280,896,334912,334528
5214,333696,1216,896,334912,334592
5215,333760,1152,896,334912,334656
5216,333824,1088,896,334912,334720
5217,333888,1024,896,334912,334784
5218,333952,960,896,334912,334848
5219,334016,896,896,334912,334912
5220,334080,832,896,334912,334976
5221,334144,768,896,334912,335040
5222,334208,704,896,334912,335104
5223,334272,640,896,334912,335168
5224,334336,576,896,334912,335232
5225,334400,512,896,334912,335296
5226,334464,448,896,334912,335360
5227,334528,384,896,334912,335424
5228,334592,320,896,334912,335488
5229,334656,42496,896,377152,335552
5230,334720,42432,896,377152,335616
5231,334784,42368,896,377152,335680
5232,334848,42304,896,377152,335744
5233,334912,42240,896,377152,335808
5234,334976,42176,896,377152,335872
5235,335040,42112,896,377152,335936
5236,335104,42048,896,377152,336000
5237,335168,41984,896,377152,336064
5238,335232,41920,896,377152,336128
5239,335296,41856,896,377152,336192
5240,335360,41792,896,377152,336256
5241,335424,41728,896,377152,336320
5242,335488,41664,896,377152,336384
5243,335552,41600,896,377152,336448
5244,335616,41536,896,377152,336512
5245,335680,41472,896,377152,336576
5246,335744,41408,896,377152,336640
5247,335808,41344,896,377152,336704
5248,335872,41280,896,377152,336768
5249,335936,41216,896,377152,336832
5250,336000,41152,896,377152,336896
5251,336064,41088,896,377152,336960
5252,336128,41024,896,377152,337024
5253,336192,40960,896,377152,337088
5254,336256,40896,896,377152,337152
5255,336320,40832,896,377152,337216
5256,336384,40768,896,377152,337280
5257,336448,40704,896,377152,337344
5258,336512,40640,896,377152,337408
5259,336576,40576,896,377152,337472
5260,336640,40512,896,377152,337536
5261,336704,40448,896,377152,337600
5262,336768,40384,896,377152,337664
5263,336832,40320,896,377152,337728
5264,336896,40256,896,377152,337792
5265,336960,40192,896,377152,337856
5266,337024,40128,896,377152,337920
5267,337088,40064,896,377152,337984
5268,337152,40000,896,377152,338048
5269,337216,39936,896,377152,338112
5270,337280,39872,896,377152,338176
5271,337344,39808,896,377152,338240
5272,337408,39744,896,377152,338304
5273,337472,39680,896,377152,338368
5274,337536,39616,896,377152,338432
5275,337600,39552,896,377152,338496
5276,337664,39488,896,377152,338560
5277,337728,39424,896,377152,338624
5278,337792,39360,896,377152,338688
5279,337856,39296,896,377152,338752
5280,337920,39232,896,377152,338816
5281,337984,39168,896,377152,338880
5282,338048,39104,896,377152,338944
5283,338112,39040,896,377152,339008
5284,338176,38976,896,377152,339072
5285,338240,38912,896,377152,339136
5286,338304,38848,896,377152,339200
5287,338368,38784,896,377152,339264
5288,338432,38720,896,377152,339328
5289,338496,38656,896,377152,339392
5290,338560,38592,896,377152,339456
5291,338624,38528,896,377152,339520
5292,338688,38464,896,377152,339584
5293,338752,38400,896,377152,339648
5294,338816,38336,896,377152,339712
5295,338880,38272,896,377152,339776
5296,338944,38208,896,377152,339840
5297,339008,38144,896,377152,339904
5298,339072,38080,896,377152,339968
5299,339136,38016,896,377152,340032
5300,339200,37952,896,377152,340096
5301,339264,37888,896,377152,340160
5302,339328,37824,896,377152,340224
5303,339392,37760,896,377152,340288
5304,339456,37696,896,377152,340352
5305,339520,37632,896,377152,340416
5306,339584,37568,896,377152,340480
5307,339648,37504,896,377152,340544
5308,339712,37440,896,377152,340608
5309,339776,37376,896,377152,340672
5310,339840,37312,896,377152,340736
5311,339904,37248,896,377152,340800
5312,339968,37184,896,377152,340864
5313,340032,37120,896,377152,340928
5314,340096,37056,896,377152,340992
5315,340160,36992,896,377152,341056
5316,340224,36928,896,377152,341120
5317,340288,36864,896,377152,341184
5318,340352,36800,896,377152,341248
5319,340416,36736,896,377152,341312
5320,340480,36672,896,377152,341376
5321,340544,36608,896,377152,341440
5322,340608,36544,896,377152,341504
5323,340672,36480,896,377152,341568
5324,340736,36416,896,377152,341632
5325,340800,36352,896,377152,341696
5326,340864,36288,896,377152,341760
5327,340928,36224,896,377152,341824
5328,340992,36160,896,377152,341888
5329,341056,36096,896,377152,341952
5330,341120,36032,896,377152,342016
5331,341184,35968,896,377152,342080
5332,341248,35904,896,377152,342144
5333,341312,35840,896,377152,342208
5334,341376,35776,896,377152,342272
5335,341440,35712,896,377152,342336
5336,341504,35648,896,377152,342400
5337,341568,35584,896,377152,342464
5338,341632,35520,896,377152,342528
5339,341696,35456,896,377152,342592
5340,341760,35392,896,377152,342656
5341,341824,35328,896,377152,342720
5342,341888,35264,896,377152,342784
5343,341952,35200,896,377152,342848
5344,342016,35136,896,377152,342912
5345,342080,35072,896,377152,342976
5346,342144,35008,896,377152,343040
5347,342208,34944,896,377152,343104
5348,342272,34880,896,377152,343168
5349,342336,34816,896,377152,343232
5350,342400,34752,896,377152,343296
5351,342464,34688,896,377152,343360
5352,342528,34624,896,377152,343424
5353,342592,34560,896,377152,343488
5354,342656,34496,896,377152,343552
5355,342720,34432,896,377152,343616
5356,342784,34368,896,377152,343680
5357,342848,34304,896,377152,343744
5358,342912,34240,896,377152,343808
5359,342976,34176,896,377152,343872
5360,343040,34112,896,377152,343936
5361,343104,34048,896,377152,344000
5362,343168,33984,896,377152,344064
5363,343232,33920,896,377152,344128
5364,343296,33856,896,377152,344192
5365,343360,33792,896,377152,344256
5366,343424,33728,896,377152,344320
5367,343488,33664,896,377152,344384
5368,343552,33600,896,377152,344448
5369,343616,33536,896,377152,344512
5370,343680,33472,896,377152,344576
5371,343744,33408,896,377152,344640
5372,343808,33344,896,377152,344704
5373,343872,33280,896,377152,344768
5374,343936,33216,896,377152,344832
5375,344000,33152,896,377152,344896
5376,344064,33088,896,377152,344960
5377,344128,33024,896,377152,345024
5378,344192,32960,896,377152,345088
5379,344256,32896,896,377152,345152
5380,344320,32832,896,377152,345216
5381,344384,32768,896,377152,345280
5382,344448,32704,896,377152,345344
5383,344512,32640,896,377152,345408
5384,344576,32576,896,377152,345472
5385,344640,32512,896,377152,345536
5386,344704,32448,896,377152,345600
5387,344768,32384,896,377152,345664
5388,344832,32320,896,377152,345728
5389,344896,32256,896,377152,345792
5390,344960,32192,896,377152,345856
5391,345024,32128,896,377152,345920
5392,345088,32064,896,377152,345984
5393,345152,32000,896,377152,346048
5394,345216,31936,896,377152,346112
5395,345280,31872,896,377152,346176
5396,345344,31808,896,377152,346240
5397,345408,31744,896,377152,346304
5398,345472,31680,896,377152,346368
5399,345536,31616,896,377152,346432
5400,345600,31552,896,377152,346496
5401,345664,31488,896,377152,346560
5402,345728,31424,896,377152,346624
5403,345792,31360,896,377152,346688
5404,345856,31296,896,377152,346752
5405,345920,31232,896,377152,346816
5406,345984,31168,896,377152,346880
5407,346048,31104,896,377152,346944
5408,346112,31040,896,377152,347008
5409,346176,30976,896,377152,347072
5410,346240,30912,896,377152,347136
5411,346304,30848,896,377152,347200
5412,346368,30784,896,377152,347264
5413,346432,30720,896,377152,347328
5414,346496,30656,896,377152,347392
5415,346560,30592,896,377152,347456
5416,346624,30528,896,377152,347520
5417,346688,30464,896,377152,347584
5418,346752,30400,896,377152,347648
5419,346816,30336,896,377152,347712
5420,346880,30272,896,377152,347776
5421,346944,30208,896,377152,347840
5422,347008,30144,896,377152,347904
5423,347072,30080,896,377152,347968
5424,347136,30016,896,377152,348032
5425,347200,29952,896,377152,348096
5426,347264,29888,896,377152,348160
5427,347328,29824,896,377152,348224
5428,347392,29760,896,377152,348288
5429,347456,29696,896,377152,348352
5430,347520,29632,896,377152,348416
5431,347584,29568,896,377152,348480
5432,347648,29504,896,377152,348544
5433,347712,29440,896,377152,348608
5434,347776,29376,896,377152,348672
5435,347840,29312,896,377152,348736
5436,347904,29248,896,377152,348800
5437,347968,29184,896,377152,348864
5438,348032,29120,896,377152,348928
5439,348096,29056,896,377152,348992
5440,348160,28992,896,377152,349056
5441,348224,28928,896,377152,349120
5442,348288,28864,896,377152,349184
5443,348352,28800,896,377152,349248
5444,348416,28736,896,377152,349312
5445,348480,28672,896,377152,349376
5446,348544,28608,896,377152,349440
5447,348608,28544,896,377152,349504
5448,348672,28480,896,377152,349568
5449,348736,28416,896,377152,349632
5450,348800,28352,896,377152,349696
5451,348864,28288,896,377152,349760
5452,348928,28224,896,377152,349824
5453,348992,28160,896,377152,349888
5454,349056,28096,896,377152,349952
5455,349120,28032,896,377152,350016
5456,349184,27968,896,377152,350080
5457,349248,27904,896,377152,350144
5458,349312,27840,896,377152,350208
5459,349376,27776,896,377152,350272
5460,349440,27712,896,377152,350336
5461,349504,27648,896,377152,350400
5462,349568,27584,896,377152,350464
5463,349632,27520,896,377152,350528
5464,349696,27456,896,377152,350592
5465,349760,27392,896,377152,350656
5466,349824,27328,896,377152,350720
5467,349888,27264,896,377152,350784
5468,349952,27200,896,377152,350848
5469,350016,27136,896,377152,350912
5470,350080,27072,896,377152,350976
5471,350144,27008,896,377152,351040
5472,350208,26944,896,377152,351104
5473,350272,26880,896,377152,351168
5474,350336,26816,896,377152,351232
5475,350400,26752,896,377152,351296
5476,350464,26688,896,377152,351360
5477,350528,26624,896,377152,351424
5478,350592,26560,896,377152,351488
5479,350656,26496,896,377152,351552
5480,350720,26432,896,377152,351616
5481,350784,26368,896,377152,351680
5482,350848,26304,896,377152,351744
5483,350912,26240,896,377152,351808
5484,350976,26176,896,377152,351872
5485,351040,26112,896,377152,351936
5486,351104,26048,896,377152,352000
5487,351168,25984,896,377152,352064
5488,351232,25920,896,377152,352128
5489,351296,25856,896,377152,352192
5490,351360,25792,896,377152,352256
5491,351424,25728,896,377152,352320
5492,351488,25664,896,377152,352384
5493,351552,25600,896,377152,352448
5494,351616,25536,896,377152,352512
5495,351680,25472,896,377152,352576
5496,351744,25408,896,377152,352640
5497,351808,25344,896,377152,352704
5498,351872,25280,896,377152,352768
5499,351936,25216,896,377152,352832
5500,352000,25152,896,377152,352896
5501,352064,25088,896,377152,352960
5502,352128,25024,896,377152,353024
5503,352192,24960,896,377152,353088
5504,352256,24896,896,377152,353152
5505,352320,24832,896,377152,353216
5506,352384,24768,896,377152,353280
5507,352448,24704,896,377152,353344
5508,352512,24640,896,377152,353408
5509,352576,24576,896,377152,353472
5510,352640,24512,896,377152,353536
5511,352704,24448,896,377152,353600
5512,352768,24384,896,377152,353664
5513,352832,24320,896,377152,353728
5514,352896,24256,896,377152,353792
5515,352960,24192,896,377152,353856
5516,353024,24128,896,377152,353920
5517,353088,24064,896,377152,353984
5518,353152,24000,896,377152,354048
5519,353216,23936,896,377152,354112
5520,353280,23872,896,377152,354176
5521,353344,23808,896,377152,354240
5522,353408,23744,896,377152,354304
5523,353472,23680,896,377152,354368
5524,353536,23616,896,377152,354432
5525,353600,23552,896,377152,354496
5526,353664,23488,896,377152,354560
5527,353728,23424,896,377152,354624
5528,353792,23360,896,377152,354688
5529,353856,23296,896,377152,354752
5530,353920,23232,896,377152,354816
5531,353984,23168,896,377152,354880
5532,354048,23104,896,377152,354944
5533,354112,23040,896,377152,355008
5534,354176,22976,896,377152,355072
5535,354240,22912,896,377152,355136
5536,354304,22848,896,377152,355200
5537,354368,22784,896,377152,355264
5538,354432,22720,896,377152,355328
5539,354496,22656,896,377152,355392
5540,354560,22592,896,377152,355456
5541,354624,22528,896,377152,355520
5542,354688,22464,896,377152,355584
5543,354752,22400,896,377152,355648
5544,354816,22336,896,377152,355712
5545,354880,22272,896,377152,355776
5546,354944,22208,896,377152,355840
5547,355008,22144,896,377152,355904
5548,355072,22080,896,377152,355968
5549,355136,22016,896,377152,356032
5550,355200,21952,896,377152,356096
5551,355264,21888,896,377152,356160
5552,355328,21824,896,377152,356224
5553,355392,21760,896,377152,356288
5554,355456,21696,896,377152,356352
5555,355520,21632,896,377152,356416
5556,355584,21568,896,377152,356480
5557,355648,21504,896,377152,356544
5558,355712,21440,896,377152,356608
5559,355776,21376,896,377152,356672
5560,355840,21312,896,377152,356736
5561,355904,21248,896,377152,356800
5562,355968,21184,896,377152,356864
5563,356032,21120,896,377152,356928
5564,356096,21056,896,377152,356992
5565,356160,20992,896,377152,357056
5566,356224,20928,896,377152,357120
5567,356288,20864,896,377152,357184
5568,356352,20800,896,377152,357248
5569,356416,20736,896,377152,357312
5570,356480,20672,896,377152,357376
5571,356544,20608,896,377152,357440
5572,356608,20544,896,377152,357504
5573,356672,20480,896,377152,357568
5574,356736,20416,896,377152,357632
5575,356800,20352,896,377152,357696
5576,356864,20288,896,377152,357760
5577,356928,20224,896,377152,357824
5578,356992,20160,896,377152,357888
5579,357056,20096,896,377152,357952
5580,357120,20032,896,377152,358016
5581,357184,19968,896,377152,358080
5582,357248,19904,896,377152,358144
5583,357312,19840,896,377152,358208
5584,357376,19776,896,377152,358272
5585,357440,19712,896,377152,358336
5586,357504,19648,896,377152,358400
5587,357568,19584,896,377152,358464
5588,357632,19520,896,377152,358528
5589,357696,19456,896,377152,358592
5590,357760,19392,896,377152,358656
5591,357824,19328,896,377152,358720
5592,357888,19264,896,377152,358784
5593,357952,19200,896,377152,358848
5594,358016,19136,896,377152,358912
5595,358080,19072,896,377152,358976
5596,358144,19008,896,377152,359040
5597,358208,18944,896,377152,359104
5598,358272,18880,896,377152,359168
5599,358336,18816,896,377152,359232
5600,358400,18752,896,377152,359296
5601,358464,18688,896,377152,359360
5602,358528,18624,896,377152,359424
5603,358592,18560,896,377152,359488
5604,358656,18496,896,377152,359552
5605,358720,18432,896,377152,359616
5606,358784,18368,896,377152,359680
5607,358848,18304,896,377152,359744
5608,358912,18240,896,377152,359808
5609,358976,18176,896,377152,359872
5610,359040,18112,896,377152,359936
5611,359104,18048,896,377152,360000
5612,359168,17984,896,377152,360064
5613,359232,17920,896,377152,360128
5614,359296,17856,896,377152,360192
5615,359360,17792,896,377152,360256
5616,359424,17728,896,377152,360320
5617,359488,17664,896,377152,360384
5618,359552,17600,896,377152,360448
5619,359616,17536,896,377152,360512
5620,359680,17472,896,377152,360576
5621,359744,17408,896,377152,360640
5622,359808,17344,896,377152,360704
5623,359872,17280,896,377152,360768
5624,359936,17216,896,377152,360832
5625,360000,17152,896,377152,360896
5626,360064,17088,896,377152,360960
5627,360128,17024,896,377152,361024
5628,360192,16960,896,377152,361088
5629,360256,16896,896,377152,361152
5630,360320,16832,896,377152,361216
5631,360384,16768,896,377152,361280
5632,360448,16704,896,377152,361344
5633,360512,16640,896,377152,361408
5634,360576,16576,896,377152,361472
5635,360640,16512,896,377152,361536
5636,360704,16448,896,377152,361600
5637,360768,16384,896,377152,361664
5638,360832,16320,896,377152,361728
5639,360896,16256,896,377152,361792
5640,360960,16192,896,377152,361856
5641,361024,16128,896,377152,361920
5642,361088,16064,896,377152,361984
5643,361152,16000,896,377152,362048
5644,361216,15936,896,377152,362112
5645,361280,15872,896,377152,362176
5646,361344,15808,896,377152,362240
5647,361408,15744,896,377152,362304
5648,361472,15680,896,377152,362368
5649,361536,15616,896,377152,362432
5650,361600,15552,896,377152,362496
5651,361664,15488,896,377152,362560
5652,361728,15424,896,377152,362624
5653,361792,15360,896,377152,362688
5654,361856,15296,896,377152,362752
5655,361920,15232,896,377152,362816
5656,361984,15168,896,377152,362880
5657,362048,15104,896,377152,362944
5658,362112,15040,896,377152,363008
5659,362176,14976,896,377152,363072
5660,362240,14912,896,377152,363136
5661,362304,14848,896,377152,363200
5662,362368,14784,896,377152,363264
5663,362432,14720,896,377152,363328
5664,362496,14656,896,377152,363392
5665,362560,14592,896,377152,363456
5666,362624,14528,896,377152,363520
5667,362688,14464,896,377152,363584
5668,362752,14400,896,377152,363648
5669,362816,14336,896,377152,363712
5670,362880,14272,896,377152,363776
5671,362944,14208,896,377152,363840
5672,363008,14144,896,377152,363904
5673,363072,14080,896,377152,363968
5674,363136,14016,896,377152,364032
5675,363200,13952,896,377152,364096
5676,363264,13888,896,377152,364160
5677,363328,13824,896,377152,364224
5678,363392,13760,896,377152,364288
5679,363456,13696,896,377152,364352
5680,363520,13632,896,377152,364416
5681,363584,13568,896,377152,364480
5682,363648,13504,896,377152,364544
5683,363712,13440,896,377152,364608
5684,363776,13376,896,377152,364672
5685,363840,13312,896,377152,364736
5686,363904,13248,896,377152,364800
5687,363968,13184,896,377152,364864
5688,364032,13120,896,377152,364928
5689,364096,13056,896,377152,364992
5690,364160,12992,896,377152,365056
5691,364224,12928,896,377152,365120
5692,364288,12864,896,377152,365184
5693,364352,12800,896,377152,365248
5694,364416,12736,896,377152,365312
5695,364480,12672,896,377152,365376
5696,364544,12608,896,377152,365440
5697,364608,12544,896,377152,365504
5698,364672,12480,896,377152,365568
5699,364736,12416,896,377152,365632
5700,364800,12352,896,377152,365696
5701,364864,12288,896,377152,365760
5702,364928,12224,896,377152,365824
5703,364992,12160,896,377152,365888
5704,365056,12096,896,377152,365952
5705,365120,12032,896,377152,366016
5706,365184,11968,896,377152,366080
5707,365248,11904,896,377152,366144
5708,365312,11840,896,377152,366208
5709,365376,11776,896,377152,366272
5710,365440,11712,896,377152,366336
5711,365504,11648,896,377152,366400
5712,365568,11584,896,377152,366464
5713,365632,11520,896,377152,366528
5714,365696,11456,896,377152,366592
5715,365760,11392,896,377152,366656
5716,365824,11328,896,377152,366720
5717,365888,11264,896,377152,366784
5718,365952,11200,896,377152,366848
5719,366016,11136,896,377152,366912
5720,366080,11072,896,377152,366976
5721,366144,11008,896,377152,367040
5722,366208,10944,896,377152,367104
5723,366272,10880,896,377152,367168
5724,366336,10816,896,377152,367232
5725,366400,10752,896,377152,367296
5726,366464,10688,896,377152,367360
5727,366528,10624,896,377152,367424
5728,366592,10560,896,377152,367488
5729,366656,10496,896,377152,367552
5730,366720,10432,896,377152,367616
5731,366784,10368,896,377152,367680
5732,366848,10304,896,377152,367744
5733,366912,10240,896,377152,367808
5734,366976,10176,896,377152,367872
5735,367040,10112,896,377152,367936
5736,367104,10048,896,377152,368000
5737,367168,9984,896,377152,368064
5738,367232,9920,896,377152,368128
5739,367296,9856,896,377152,368192
5740,367360,9792,896,377152,368256
5741,367424,9728,896,377152,368320
5742,367488,9664,896,377152,368384
5743,367552,9600,896,377152,368448
5744,367616,9536,896,377152,368512
5745,367680,9472,896,377152,368576
5746,367744,9408,896,377152,368640
5747,367808,9344,896,377152,368704
5748,367872,9280,896,377152,368768
5749,367936,9216,896,377152,368832
5750,368000,9152,896,377152,368896
5751,368064,9088,896,377152,368960
5752,368128,9024,896,377152,369024
5753,368192,8960,896,377152,369088
5754,368256,8896,896,377152,369152
5755,368320,8832,896,377152,369216
5756,368384,8768,896,377152,369280
5757,368448,8704,896,377152,369344
5758,368512,8640,896,377152,369408
5759,368576,8576,896,377152,369472
5760,368640,8512,896,377152,369536
5761,368704,8448,896,377152,369600
5762,368768,8384,896,377152,369664
5763,368832,8320,896,377152,369728
5764,368896,8256,896,377152,369792
5765,368960,8192,896,377152,369856
5766,369024,8128,896,377152,369920
5767,369088,8064,896,377152,369984
5768,369152,8000,896,377152,370048
5769,369216,7936,896,377152,370112
5770,369280,7872,896,377152,370176
5771,369344,7808,896,377152,370240
5772,369408,7744,896,377152,370304
5773,369472,7680,896,377152,370368
5774,369536,7616,896,377152,370432
5775,369600,7552,896,377152,370496
5776,369664,7488,896,377152,370560
5777,369728,7424,896,377152,370624
5778,369792,7360,896,377152,370688
5779,369856,7296,896,377152,370752
5780,369920,7232,896,377152,370816
5781,369984,7168,896,377152,370880
5782,370048,7104,896,377152,370944
5783,370112,7040,896,377152,371008
5784,370176,6976,896,377152,371072
5785,370240,6912,896,377152,371136
5786,370304,6848,896,377152,371200
5787,370368,6784,896,377152,371264
5788,370432,6720,896,377152,371328
5789,370496,6656,896,377152,371392
5790,370560,6592,896,377152,371456
5791,370624,6528,896,377152,371520
5792,370688,6464,896,377152,371584
5793,370752,6400,896,377152,371648
5794,370816,6336,896,377152,371712
5795,370880,6272,896,377152,371776
5796,370944,6208,896,377152,371840
5797,371008,6144,896,377152,371904
5798,371072,6080,896,377152,371968
5799,371136,6016,896,377152,372032
5800,371200,5952,896,377152,372096
5801,371264,5888,896,377152,372160
5802,371328,5824,896,377152,372224
5803,371392,5760,896,377152,372288
5804,371456,5696,896,377152,372352
5805,371520,5632,896,377152,372416
5806,371584,5568,896,377152,372480
5807,371648,5504,896,377152,372544
5808,371712,5440,896,377152,372608
5809,371776,5376,896,377152,372672
5810,371840,5312,896,377152,372736
5811,371904,5248,896,377152,372800
5812,371968,5184,896,377152,372864
5813,372032,5120,896,377152,372928
5814,372096,5056,896,377152,372992
5815,372160,4992,896,377152,373056
5816,372224,4928,896,377152,373120
5817,372288,4864,896,377152,373184
5818,372352,4800,896,377152,373248
5819,372416,4736,896,377152,373312
5820,372480,4672,896,377152,373376
5821,372544,4608,896,377152,373440
5822,372608,4544,896,377152,373504
5823,372672,4480,896,377152,373568
5824,372736,4416,896,377152,373632
5825,372800,4352,896,377152,373696
5826,372864,4288,896,377152,373760
5827,372928,4224,896,377152,373824
5828,372992,4160,896,377152,373888
5829,373056,4096,896,377152,373952
5830,373120,4032,896,377152,374016
5831,373184,3968,896,377152,374080
5832,373248,3904,896,377152,374144
5833,373312,3840,896,377152,374208
5834,373376,3776,896,377152,374272
5835,373440,3712,896,377152,374336
5836,373504,3648,896,377152,374400
5837,373568,3584,896,377152,374464
5838,373632,3520,896,377152,374528
5839,373696,3456,896,377152,374592
5840,373760,3392,896,377152,374656
5841,373824,3328,896,377152,374720
5842,373888,3264,896,377152,374784
5843,373952,3200,896,377152,374848
5844,374016,3136,896,377152,374912
5845,374080,3072,896,377152,374976
5846,374144,3008,896,377152,375040
5847,374208,2944,896,377152,375104
5848,374272,2880,896,377152,375168
5849,374336,2816,896,377152,375232
5850,374400,2752,896,377152,375296
5851,374464,2688,896,377152,375360
5852,374528,2624,896,377152,375424
5853,374592,2560,896,377152,375488
5854,374656,2496,896,377152,375552
5855,374720,2432,896,377152,375616
5856,374784,2368,896,377152,375680
5857,374848,2304,896,377152,375744
5858,374912,2240,896,377152,375808
5859,374976,2176,896,377152,375872
5860,375040,2112,896,377152,375936
5861,375104,2048,896,377152,376000
5862,375168,1984,896,377152,376064
5863,375232,1920,896,377152,376128
5864,375296,1856,896,377152,376192
5865,375360,1792,896,377152,376256
5866,375424,1728,896,377152,376320
5867,375488,1664,896,377152,376384
5868,375552,1600,896,377152,376448
5869,375616,1536,896,377152,376512
5870,375680,1472,896,377152,376576
5871,375744,1408,896,377152,376640
5872,375808,1344,896,377152,376704
5873,375872,1280,896,377152,376768
5874,375936,1216,896,377152,376832
5875,376000,1152,896,377152,376896
5876,376064,1088,896,377152,376960
5877,376128,1024,896,377152,377024
5878,376192,960,896,377152,377088
5879,376256,896,896,377152,377152
5880,376320,832,896,377152,377216
5881,376384,768,896,377152,377280
5882,376448,704,896,377152,377344
5883,376512,640,896,377152,377408
5884,376576,576,896,377152,377472
5885,376640,512,896,377152,377536
5886,376704,448,896,377152,377600
5887,376768,384,896,377152,377664
5888,376832,320,896,377152,377728
5889,376896,47616,896,424512,377792
5890,376960,47552,896,424512,377856
5891,377024,47488,896,424512,377920
5892,377088,47424,896,424512,377984
5893,377152,47360,896,424512,378048
5894,377216,47296,896,424512,378112
5895,377280,47232,896,424512,378176
5896,377344,47168,896,424512,378240
5897,377408,47104,896,424512,378304
5898,377472,47040,896,424512,378368
5899,377536,46976,896,424512,378432
5900,377600,46912,896,424512,378496
5901,377664,46848,896,424512,378560
5902,377728,46784,896,424512,378624
5903,377792,46720,896,424512,378688
5904,377856,46656,896,424512,378752
5905,377920,46592,896,424512,378816
5906,377984,46528,896,424512,378880
5907,378048,46464,896,424512,378944
5908,378112,46400,896,424512,379008
5909,378176,46336,896,424512,379072
5910,378240,46272,896,424512,379136
5911,378304,46208,896,424512,379200
5912,378368,46144,896,424512,379264
5913,378432,46080,896,424512,379328
5914,378496,46016,896,424512,379392
5915,378560,45952,896,424512,379456
5916,378624,45888,896,424512,379520
5917,378688,45824,896,424512,379584
5918,378752,45760,896,424512,379648
5919,378816,45696,896,424512,379712
5920,378880,45632,896,424512,379776
5921,378944,45568,896,424512,379840
5922,379008,45504,896,424512,379904
5923,379072,45440,896,424512,379968
5924,379136,45376,896,424512,380032
5925,379200,45312,896,424512,380096
5926,379264,45248,896,424512,380160
5927,379328,45184,896,424512,380224
5928,379392,45120,896,424512,380288
5929,379456,45056,896,424512,380352
5930,379520,44992,896,424512,380416
5931,379584,44928,896,424512,380480
5932,379648,44864,896,424512,380544
5933,379712,44800,896,424512,380608
5934,379776,44736,896,424512,380672
5935,379840,44672,896,424512,380736
5936,379904,44608,896,424512,380800
5937,379968,44544,896,424512,380864
5938,380032,44480,896,424512,380928
5939,380096,44416,896,424512,380992
5940,380160,44352,896,424512,381056
5941,380224,44288,896,424512,381120
5942,380288,44224,896,424512,381184
5943,380352,44160,896,424512,381248
5944,380416,44096,896,424512,381312
5945,380480,44032,896,424512,381376
5946,380544,43968,896,424512,381440
5947,380608,43904,896,424512,381504
5948,380672,43840,896,424512,381568
5949,380736,43776,896,424512,381632
5950,380800,43712,896,424512,381696
5951,380864,43648,896,424512,381760
5952,380928,43584,896,424512,381824
5953,380992,43520,896,424512,381888
5954,381056,43456,896,424512,381952
5955,381120,43392,896,424512,382016
5956,381184,43328,896,424512,382080
5957,381248,43264,896,424512,382144
5958,381312,43200,896,424512,382208
5959,381376,43136,896,424512,382272
5960,381440,43072,896,424512,382336
5961,381504,43008,896,424512,382400
5962,381568,42944,896,424512,382464
5963,381632,42880,896,424512,382528
5964,381696,42816,896,424512,382592
5965,381760,42752,896,424512,382656
5966,381824,42688,896,424512,382720
5967,381888,42624,896,424512,382784
5968,381952,42560,896,424512,382848
5969,382016,42496,896,424512,382912
5970,382080,42432,896,424512,382976
5971,382144,42368,896,424512,383040
5972,382208,42304,896,424512,383104
5973,382272,42240,896,424512,383168
5974,382336,42176,896,424512,383232
5975,382400,42112,896,424512,383296
5976,382464,42048,896,424512,383360
5977,382528,41984,896,424512,383424
5978,382592,41920,896,424512,383488
5979,382656,41856,896,424512,383552
5980,382720,41792,896,424512,383616
5981,382784,41728,896,424512,383680
5982,382848,41664,896,424512,383744
5983,382912,41600,896,424512,383808
5984,382976,41536,896,424512,383872
5985,383040,41472,896,424512,383936
5986,383104,41408,896,424512,384000
5987,383168,41344,896,424512,384064
5988,383232,41280,896,424512,384128
5989,383296,41216,896,424512,384192
5990,383360,41152,896,424512,384256
5991,383424,41088,896,424512,384320
5992,383488,41024,896,424512,384384
5993,383552,40960,896,424512,384448
5994,383616,40896,896,424512,384512
5995,383680,40832,896,424512,384576
5996,383744,40768,896,424512,384640
5997,383808,40704,896,424512,384704
5998,383872,40640,896,424512,384768
5999,383936,40576,896,424512,384832
6000,384000,40512,896,424512,384896
6001,384064,40448,896,424512,384960
6002,384128,40384,896,424512,385024
6003,384192,40320,896,424512,385088
6004,384256,40256,896,424512,385152
6005,384320,40192,896,424512,385216
6006,384384,40128,896,424512,385280
6007,384448,40064,896,424512,385344
6008,384512,40000,896,424512,385408
6009,384576,39936,896,424512,385472
6010,384640,39872,896,424512,385536
6011,384704,39808,896,424512,385600
6012,384768,39744,896,424512,385664
6013,384832,39680,896,424512,385728
6014,384896,39616,896,424512,385792
6015,384960,39552,896,424512,385856
6016,385024,39488,896,424512,385920
6017,385088,39424,896,424512,385984
6018,385152,39360,896,424512,386048
6019,385216,39296,896,424512,386112
6020,385280,39232,896,424512,386176
6021,385344,39168,896,424512,386240
6022,385408,39104,896,424512,386304
6023,385472,39040,896,424512,386368
6024,385536,38976,896,424512,386432
6025,385600,38912,896,424512,386496
6026,385664,38848,896,424512,386560
6027,385728,38784,896,424512,386624
6028,385792,38720,896,424512,386688
6029,385856,38656,896,424512,386752
6030,385920,38592,896,424512,386816
6031,385984,38528,896,424512,386880
6032,386048,38464,896,424512,386944
6033,386112,38400,896,424512,387008
6034,386176,38336,896,424512,387072
6035,386240,38272,896,424512,387136
6036,386304,38208,896,424512,387200
6037,386368,38144,896,424512,387264
6038,386432,38080,896,424512,387328
6039,386496,38016,896,424512,387392
6040,386560,37952,896,424512,387456
6041,386624,37888,896,424512,387520
6042,386688,37824,896,424512,387584
6043,386752,37760,896,424512,387648
6044,386816,37696,896,424512,387712
6045,386880,37632,896,424512,387776
6046,386944,37568,896,424512,387840
6047,387008,37504,896,424512,387904
6048,387072,37440,896,424512,387968
6049,387136,37376,896,424512,388032
6050,387200,37312,896,424512,388096
6051,387264,37248,896,424512,388160
6052,387328,37184,896,424512,388224
6053,387392,37120,896,424512,388288
6054,387456,37056,896,424512,388352
6055,387520,36992,896,424512,388416
6056,387584,36928,896,424512,388480
6057,387648,36864,896,424512,388544
6058,387712,36800,896,424512,388608
6059,387776,36736,896,424512,388672
6060,387840,36672,896,424512,388736
6061,387904,36608,896,424512,388800
6062,387968,36544,896,424512,388864
6063,388032,36480,896,424512,388928
6064,388096,36416,896,424512,388992
6065,388160,36352,896,424512,389056
6066,388224,36288,896,424512,389120
6067,388288,36224,896,424512,389184
6068,388352,36160,896,424512,389248
6069,388416,36096,896,424512,389312
6070,388480,36032,896,424512,389376
6071,388544,35968,896,424512,389440
6072,388608,35904,896,424512,389504
6073,388672,35840,896,424512,389568
6074,388736,35776,896,424512,389632
6075,388800,35712,896,424512,389696
6076,388864,35648,896,424512,389760
6077,388928,35584,896,424512,389824
6078,388992,35520,896,424512,389888
6079,389056,35456,896,424512,389952
6080,389120,35392,896,424512,390016
6081,389184,35328,896,424512,390080
6082,389248,35264,896,424512,390144
6083,389312,35200,896,424512,390208
6084,389376,35136,896,424512,390272
6085,389440,35072,896,424512,390336
6086,389504,35008,896,424512,390400
6087,389568,34944,896,424512,390464
6088,389632,34880,896,424512,390528
6089,389696,34816,896,424512,390592
6090,389760,34752,896,424512,390656
6091,389824,34688,896,424512,390720
6092,389888,34624,896,424512,390784
6093,389952,34560,896,424512,390848
6094,390016,34496,896,424512,390912
6095,390080,34432,896,424512,390976
6096,390144,34368,896,424512,391040
6097,390208,34304,896,424512,391104
6098,390272,34240,896,424512,391168
6099,390336,34176,896,424512,391232
6100,390400,34112,896,424512,391296
6101,390464,34048,896,424512,391360
6102,390528,33984,896,424512,391424
6103,390592,33920,896,424512,391488
6104,390656,33856,896,424512,391552
6105,390720,33792,896,424512,391616
6106,390784,33728,896,424512,391680
6107,390848,33664,896,424512,391744
6108,390912,33600,896,424512,391808
6109,390976,33536,896,424512,391872
6110,391040,33472,896,424512,391936
6111,391104,33408,896,424512,392000
6112,391168,33344,896,424512,392064
6113,391232,33280,896,424512,392128
6114,391296,33216,896,424512,392192
6115,391360,33152,896,424512,392256
6116,391424,33088,896,424512,392320
6117,391488,33024,896,424512,392384
6118,391552,32960,896,424512,392448
6119,391616,32896,896,424512,392512
6120,391680,32832,896,424512,392576
6121,391744,32768,896,424512,392640
6122,391808,32704,896,424512,392704
6123,391872,32640,896,424512,392768
6124,391936,32576,896,424512,392832
6125,392000,32512,896,424512,392896
6126,392064,32448,896,424512,392960
6127,392128,32384,896,424512,393024
6128,392192,32320,896,424512,393088
6129,392256,32256,896,424512,393152
6130,392320,32192,896,424512,393216
6131,392384,32128,896,424512,393280
6132,392448,32064,896,424512,393344
6133,392512,32000,896,424512,393408
6134,392576,31936,896,424512,393472
6135,392640,31872,896,424512,393536
6136,392704,31808,896,424512,393600
6137,392768,31744,896,424512,393664
6138,392832,31680,896,424512,393728
6139,392896,31616,896,424512,393792
6140,392960,31552,896,424512,393856
6141,393024,31488,896,424512,393920
6142,393088,31424,896,424512,393984
6143,393152,31360,896,424512,394048
6144,393216,31296,896,424512,394112
6145,393280,31232,896,424512,394176
6146,393344,31168,896,424512,394240
6147,393408,31104,896,424512,394304
6148,393472,31040,896,424512,394368
6149,393536,30976,896,424512,394432
6150,393600,30912,896,424512,394496
6151,393664,30848,896,424512,394560
6152,393728,30784,896,424512,394624
6153,393792,30720,896,424512,394688
6154,393856,30656,896,424512,394752
6155,393920,30592,896,424512,394816
6156,393984,30528,896,424512,394880
6157,394048,30464,896,424512,394944
6158,394112,30400,896,424512,395008
6159,394176,30336,896,424512,395072
6160,394240,30272,896,424512,395136
6161,394304,30208,896,424512,395200
6162,394368,30144,896,424512,395264
6163,394432,30080,896,424512,395328
6164,394496,30016,896,424512,395392
6165,394560,29952,896,424512,395456
6166,394624,29888,896,424512,395520
6167,394688,29824,896,424512,395584
6168,394752,29760,896,424512,395648
6169,394816,29696,896,424512,395712
6170,394880,29632,896,424512,395776
6171,394944,29568,896,424512,395840
6172,395008,29504,896,424512,395904
6173,395072,29440,896,424512,395968
6174,395136,29376,896,424512,396032
6175,395200,29312,896,424512,396096
6176,395264,29248,896,424512,396160
6177,395328,29184,896,424512,396224
6178,395392,29120,896,424512,396288
6179,395456,29056,896,424512,396352
6180,395520,28992,896,424512,396416
6181,395584,28928,896,424512,396480
6182,395648,28864,896,424512,396544
6183,395712,28800,896,424512,396608
6184,395776,28736,896,424512,396672
6185,395840,28672,896,424512,396736
6186,395904,28608,896,424512,396800
6187,395968,28544,896,424512,396864
6188,396032,28480,896,424512,396928
6189,396096,28416,896,424512,396992
6190,396160,28352,896,424512,397056
6191,396224,28288,896,424512,397120
6192,396288,28224,896,424512,397184
6193,396352,28160,896,424512,397248
6194,396416,28096,896,424512,397312
6195,396480,28032,896,424512,397376
6196,396544,27968,896,424512,397440
6197,396608,27904,896,424512,397504
6198,396672,27840,896,424512,397568
6199,396736,27776,896,424512,397632
6200,396800,27712,896,424512,397696
6201,396864,27648,896,424512,397760
6202,396928,27584,896,424512,397824
6203,396992,27520,896,424512,397888
6204,397056,27456,896,424512,397952
6205,397120,27392,896,424512,398016
6206,397184,27328,896,424512,398080
6207,397248,27264,896,424512,398144
6208,397312,27200,896,424512,398208
6209,397376,27136,896,424512,398272
6210,397440,27072,896,424512,398336
6211,397504,27008,896,424512,398400
6212,397568,26944,896,424512,398464
6213,397632,26880,896,424512,398528
6214,397696,26816,896,424512,398592
6215,397760,26752,896,424512,398656
6216,397824,26688,896,424512,398720
6217,397888,26624,896,424512,398784
6218,397952,26560,896,424512,398848
6219,398016,26496,896,424512,398912
6220,398080,26432,896,424512,398976
6221,398144,26368,896,424512,399040
6222,398208,26304,896,424512,399104
6223,398272,26240,896,424512,399168
6224,398336,26176,896,424512,399232
6225,398400,26112,896,424512,399296
6226,398464,26048,896,424512,399360
6227,398528,25984,896,424512,399424
6228,398592,25920,896,424512,399488
6229,398656,25856,896,424512,399552
6230,398720,25792,896,424512,399616
6231,398784,25728,896,424512,399680
6232,398848,25664,896,424512,399744
6233,398912,25600,896,424512,399808
6234,398976,25536,896,424512,399872
6235,399040,25472,896,424512,399936
6236,399104,25408,896,424512,400000
6237,399168,25344,896,424512,400064
6238,399232,25280,896,424512,400128
6239,399296,25216,896,424512,400192
6240,399360,25152,896,424512,400256
6241,399424,25088,896,424512,400320
6242,399488,25024,896,424512,400384
6243,399552,24960,896,424512,400448
6244,399616,24896,896,424512,400512
6245,399680,24832,896,424512,400576
6246,399744,24768,896,424512,400640
6247,399808,24704,896,424512,400704
6248,399872,24640,896,424512,400768
6249,399936,24576,896,424512,400832
6250,400000,24512,896,424512,400896
6251,400064,24448,896,424512,400960
6252,400128,24384,896,424512,401024
6253,400192,24320,896,424512,401088
6254,400256,24256,896,424512,401152
6255,400320,24192,896,424512,401216
6256,400384,24128,896,424512,401280
6257,400448,24064,896,424512,401344
6258,400512,24000,896,424512,401408
6259,400576,23936,896,424512,401472
6260,400640,23872,896,424512,401536
6261,400704,23808,896,424512,401600
6262,400768,23744,896,424512,401664
6263,400832,23680,896,424512,401728
6264,400896,23616,896,424512,401792
6265,400960,23552,896,424512,401856
6266,401024,23488,896,424512,401920
6267,401088,23424,896,424512,401984
6268,401152,23360,896,424512,402048
6269,401216,23296,896,424512,402112
6270,401280,23232,896,424512,402176
6271,401344,23168,896,424512,402240
6272,401408,23104,896,424512,402304
6273,401472,23040,896,424512,402368
6274,401536,22976,896,424512,402432
6275,401600,22912,896,424512,402496
6276,401664,22848,896,424512,402560
6277,401728,22784,896,424512,402624
6278,401792,22720,896,424512,402688
6279,401856,22656,896,424512,402752
6280,401920,22592,896,424512,402816
6281,401984,22528,896,424512,402880
6282,402048,22464,896,424512,402944
6283,402112,22400,896,424512,403008
6284,402176,22336,896,424512,403072
6285,402240,22272,896,424512,403136
6286,402304,22208,896,424512,403200
6287,402368,22144,896,424512,403264
6288,402432,22080,896,424512,403328
6289,402496,22016,896,424512,403392
6290,402560,21952,896,424512,403456
6291,402624,21888,896,424512,403520
6292,402688,21824,896,424512,403584
6293,402752,21760,896,424512,403648
6294,402816,21696,896,424512,403712
6295,402880,21632,896,424512,403776
6296,402944,21568,896,424512,403840
6297,403008,21504,896,424512,403904
6298,403072,21440,896,424512,403968
6299,403136,21376,896,424512,404032
6300,403200,21312,896,424512,404096
6301,403264,21248,896,424512,404160
6302,403328,21184,896,424512,404224
6303,403392,21120,896,424512,404288
6304,403456,21056,896,424512,404352
6305,403520,20992,896,424512,404416
6306,403584,20928,896,424512,404480
6307,403648,20864,896,424512,404544
6308,403712,20800,896,424512,404608
6309,403776,20736,896,424512,404672
6310,403840,20672,896,424512,404736
6311,403904,20608,896,424512,404800
6312,403968,20544,896,424512,404864
6313,404032,20480,896,424512,404928
6314,404096,20416,896,424512,404992
6315,404160,20352,896,424512,405056
6316,404224,20288,896,424512,405120
6317,404288,20224,896,424512,405184
6318,404352,20160,896,424512,405248
6319,404416,20096,896,424512,405312
6320,404480,20032,896,424512,405376
6321,404544,19968,896,424512,405440
6322,404608,19904,896,424512,405504
6323,404672,19840,896,424512,405568
6324,404736,19776,896,424512,405632
6325,404800,19712,896,424512,405696
6326,404864,19648,896,424512,405760
6327,404928,19584,896,424512,405824
6328,404992,19520,896,424512,405888
6329,405056,19456,896,424512,405952
6330,405120,19392,896,424512,406016
6331,405184,19328,896,424512,406080
6332,405248,19264,896,424512,406144
6333,405312,19200,896,424512,406208
6334,405376,19136,896,424512,406272
6335,405440,19072,896,424512,406336
6336,405504,19008,896,424512,406400
6337,405568,18944,896,424512,406464
6338,405632,18880,896,424512,406528
6339,405696,18816,896,424512,406592
6340,405760,18752,896,424512,406656
6341,405824,18688,896,424512,406720
6342,405888,18624,896,424512,406784
6343,405952,18560,896,424512,406848
6344,406016,18496,896,424512,406912
6345,406080,18432,896,424512,406976
6346,406144,18368,896,424512,407040
6347,406208,18304,896,424512,407104
6348,406272,18240,896,424512,407168
6349,406336,18176,896,424512,407232
6350,406400,18112,896,424512,407296
6351,406464,18048,896,424512,407360
6352,406528,17984,896,424512,407424
6353,406592,17920,896,424512,407488
6354,406656,17856,896,424512,407552
6355,406720,17792,896,424512,407616
6356,406784,17728,896,424512,407680
6357,406848,17664,896,424512,407744
6358,406912,17600,896,424512,407808
6359,406976,17536,896,424512,407872
6360,407040,17472,896,424512,407936
6361,407104,17408,896,424512,408000
6362,407168,17344,896,424512,408064
6363,407232,17280,896,424512,408128
6364,407296,17216,896,424512,408192
6365,407360,17152,896,424512,408256
6366,407424,17088,896,424512,408320
6367,407488,17024,896,424512,408384
6368,407552,16960,896,424512,408448
6369,407616,16896,896,424512,408512
6370,407680,16832,896,424512,408576
6371,407744,16768,896,424512,408640
6372,407808,16704,896,424512,408704
6373,407872,16640,896,424512,408768
6374,407936,16576,896,424512,408832
6375,408000,16512,896,424512,408896
6376,408064,16448,896,424512,408960
6377,408128,16384,896,424512,409024
6378,408192,16320,896,424512,409088
6379,408256,16256,896,424512,409152
6380,408320,16192,896,424512,409216
6381,408384,16128,896,424512,409280
6382,408448,16064,896,424512,409344
6383,408512,16000,896,424512,409408
6384,408576,15936,896,424512,409472
6385,408640,15872,896,424512,409536
6386,408704,15808,896,424512,409600
6387,408768,15744,896,424512,409664
6388,408832,15680,896,424512,409728
6389,408896,15616,896,424512,409792
6390,408960,15552,896,424512,409856
6391,409024,15488,896,424512,409920
6392,409088,15424,896,424512,409984
6393,409152,15360,896,424512,410048
6394,409216,15296,896,424512,410112
6395,409280,15232,896,424512,410176
6396,409344,15168,896,424512,410240
6397,409408,15104,896,424512,410304
6398,409472,15040,896,424512,410368
6399,409536,14976,896,424512,410432
6400,409600,14912,896,424512,410496
6401,409664,14848,896,424512,410560
6402,409728,14784,896,424512,410624
6403,409792,14720,896,424512,410688
6404,409856,14656,896,424512,410752
6405,409920,14592,896,424512,410816
6406,409984,14528,896,424512,410880
6407,410048,14464,896,424512,410944
6408,410112,14400,896,424512,411008
6409,410176,14336,896,424512,411072
6410,410240,14272,896,424512,411136
6411,410304,14208,896,424512,411200
6412,410368,14144,896,424512,411264
6413,410432,14080,896,424512,411328
6414,410496,14016,896,424512,411392
6415,410560,13952,896,424512,411456
6416,410624,13888,896,424512,411520
6417,410688,13824,896,424512,411584
6418,410752,13760,896,424512,411648
6419,410816,13696,896,424512,411712
6420,410880,13632,896,424512,411776
6421,410944,13568,896,424512,411840
6422,411008,13504,896,424512,411904
6423,411072,13440,896,424512,411968
6424,411136,13376,896,424512,412032
6425,411200,13312,896,424512,412096
6426,411264,13248,896,424512,412160
6427,411328,13184,896,424512,412224
6428,411392,13120,896,424512,412288
6429,411456,13056,896,424512,412352
6430,411520,12992,896,424512,412416
6431,411584,12928,896,424512,412480
6432,411648,12864,896,424512,412544
6433,411712,12800,896,424512,412608
6434,411776,12736,896,424512,412672
6435,411840,12672,896,424512,412736
6436,411904,12608,896,424512,412800
6437,411968,12544,896,424512,412864
6438,412032,12480,896,424512,412928
6439,412096,12416,896,424512,412992
6440,412160,12352,896,424512,413056
6441,412224,12288,896,424512,413120
6442,412288,12224,896,424512,413184
6443,412352,12160,896,424512,413248
6444,412416,12096,896,424512,413312
6445,412480,12032,896,424512,413376
6446,412544,11968,896,424512,413440
6447,412608,11904,896,424512,413504
6448,412672,11840,896,424512,413568
6449,412736,11776,896,424512,413632
6450,412800,11712,896,424512,413696
6451,412864,11648,896,424512,413760
6452,412928,11584,896,424512,413824
6453,412992,11520,896,424512,413888
6454,413056,11456,896,424512,413952
6455,413120,11392,896,424512,414016
6456,413184,11328,896,424512,414080
6457,413248,11264,896,424512,414144
6458,413312,11200,896,424512,414208
6459,413376,11136,896,424512,414272
6460,413440,11072,896,424512,414336
6461,413504,11008,896,424512,414400
6462,413568,10944,896,424512,414464
6463,413632,10880,896,424512,414528
6464,413696,10816,896,424512,414592
6465,413760,10752,896,424512,414656
6466,413824,10688,896,424512,414720
6467,413888,10624,896,424512,414784
6468,413952,10560,896,424512,414848
6469,414016,10496,896,424512,414912
6470,414080,10432,896,424512,414976
6471,414144,10368,896,424512,415040
6472,414208,10304,896,424512,415104
6473,414272,10240,896,424512,415168
6474,414336,10176,896,424512,415232
6475,414400,10112,896,424512,415296
6476,414464,10048,896,424512,415360
6477,414528,9984,896,424512,415424
6478,414592,9920,896,424512,415488
6479,414656,9856,896,424512,415552
6480,414720,9792,896,424512,415616
6481,414784,9728,896,424512,415680
6482,414848,9664,896,424512,415744
6483,414912,9600,896,424512,415808
6484,414976,9536,896,424512,415872
6485,415040,9472,896,424512,415936
6486,415104,9408,896,424512,416000
6487,415168,9344,896,424512,416064
6488,415232,9280,896,424512,416128
6489,415296,9216,896,424512,416192
6490,415360,9152,896,424512,416256
6491,415424,9088,896,424512,416320
6492,415488,9024,896,424512,416384
6493,415552,8960,896,424512,416448
6494,415616,8896,896,424512,416512
6495,415680,8832,896,424512,416576
6496,415744,8768,896,424512,416640
6497,415808,8704,896,424512,416704
6498,415872,8640,896,424512,416768
6499,415936,8576,896,424512,416832
6500,416000,8512,896,424512,416896
6501,416064,8448,896,424512,416960
6502,416128,8384,896,424512,417024
6503,416192,8320,896,424512,417088
6504,416256,8256,896,424512,417152
6505,416320,8192,896,424512,417216
6506,416384,8128,896,424512,417280
6507,416448,8064,896,424512,417344
6508,416512,8000,896,424512,417408
6509,416576,7936,896,424512,417472
6510,416640,7872,896,424512,417536
6511,416704,7808,896,424512,417600
6512,416768,7744,896,424512,417664
6513,416832,7680,896,424512,417728
6514,416896,7616,896,424512,417792
6515,416960,7552,896,424512,417856
6516,417024,7488,896,424512,417920
6517,417088,7424,896,424512,417984
6518,417152,7360,896,424512,418048
6519,417216,7296,896,424512,418112
6520,417280,7232,896,424512,418176
6521,417344,7168,896,424512,418240
6522,417408,7104,896,424512,418304
6523,417472,7040,896,424512,418368
6524,417536,6976,896,424512,418432
6525,417600,6912,896,424512,418496
6526,417664,6848,896,424512,418560
6527,417728,6784,896,424512,418624
6528,417792,6720,896,424512,418688
6529,417856,6656,896,424512,418752
6530,417920,6592,896,424512,418816
6531,417984,6528,896,424512,418880
6532,418048,6464,896,424512,418944
6533,418112,6400,896,424512,419008
6534,418176,6336,896,424512,419072
6535,418240,6272,896,424512,419136
6536,418304,6208,896,424512,419200
6537,418368,6144,896,424512,419264
6538,418432,6080,896,424512,419328
6539,418496,6016,896,424512,419392
6540,418560,5952,896,424512,419456
6541,418624,5888,896,424512,419520
6542,418688,5824,896,424512,419584
6543,418752,5760,896,424512,419648
6544,418816,5696,896,424512,419712
6545,418880,5632,896,424512,419776
6546,418944,5568,896,424512,419840
6547,419008,5504,896,424512,419904
6548,419072,5440,896,424512,419968
6549,419136,5376,896,424512,420032
6550,419200,5312,896,424512,420096
6551,419264,5248,896,424512,420160
6552,419328,5184,896,424512,420224
6553,419392,5120,896,424512,420288
6554,419456,5056,896,424512,420352
6555,419520,4992,896,424512,420416
6556,419584,4928,896,424512,420480
6557,419648,4864,896,424512,420544
6558,419712,4800,896,424512,420608
6559,419776,4736,896,424512,420672
6560,419840,4672,896,424512,420736
6561,419904,4608,896,424512,420800
6562,419968,4544,896,424512,420864
6563,420032,4480,896,424512,420928
6564,420096,4416,896,424512,420992
6565,420160,4352,896,424512,421056
6566,420224,4288,896,424512,421120
6567,420288,4224,896,424512,421184
6568,420352,4160,896,424512,421248
6569,420416,4096,896,424512,421312
6570,420480,4032,896,424512,421376
6571,420544,3968,896,424512,421440
6572,420608,3904,896,424512,421504
6573,420672,3840,896,424512,421568
6574,420736,3776,896,424512,421632
6575,420800,3712,896,424512,421696
6576,420864,3648,896,424512,421760
6577,420928,3584,896,424512,421824
6578,420992,3520,896,424512,421888
6579,421056,3456,896,424512,421952
6580,421120,3392,896,424512,422016
6581,421184,3328,896,424512,422080
6582,421248,3264,896,424512,422144
6583,421312,3200,896,424512,422208
6584,421376,3136,896,424512,422272
6585,421440,3072,896,424512,422336
6586,421504,3008,896,424512,422400
6587,421568,2944,896,424512,422464
6588,421632,2880,896,424512,422528
6589,421696,2816,896,424512,422592
6590,421760,2752,896,424512,422656
6591,421824,2688,896,424512,422720
6592,421888,2624,896,424512,422784
6593,421952,2560,896,424512,422848
6594,422016,2496,896,424512,422912
6595,422080,2432,896,424512,422976
6596,422144,2368,896,424512,423040
6597,422208,2304,896,424512,423104
6598,422272,2240,896,424512,423168
6599,422336,2176,896,424512,423232
6600,422400,2112,896,424512,423296
6601,422464,2048,896,424512,423360
6602,422528,1984,896,424512,423424
6603,422592,1920,896,424512,423488
6604,422656,1856,896,424512,423552
6605,422720,1792,896,424512,423616
6606,422784,1728,896,424512,423680
6607,422848,1664,896,424512,423744
6608,422912,1600,896,424512,423808
6609,422976,1536,896,424512,423872
6610,423040,1472,896,424512,423936
6611,423104,1408,896,424512,424000
6612,423168,1344,896,424512,424064
6613,423232,1280,896,424512,424128
6614,423296,1216,896,424512,424192
6615,423360,1152,896,424512,424256
6616,423424,1088,896,424512,424320
6617,423488,1024,896,424512,424384
6618,423552,960,896,424512,424448
6619,423616,896,896,424512,424512
6620,423680,832,896,424512,424576
6621,423744,768,896,424512,424640
6622,423808,704,896,424512,424704
6623,423872,640,896,424512,424768
6624,423936,576,896,424512,424832
6625,424000,512,896,424512,424896
6626,424064,448,896,424512,424960
6627,424128,384,896,424512,425024
6628,424192,320,896,424512,425088
6629,424256,53504,896,477760,425152
6630,424320,53440,896,477760,425216
6631,424384,53376,896,477760,425280
6632,424448,53312,896,477760,425344
6633,424512,53248,896,477760,425408
6634,424576,53184,896,477760,425472
6635,424640,53120,896,477760,425536
6636,424704,53056,896,477760,425600
6637,424768,52992,896,477760,425664
6638,424832,52928,896,477760,425728
6639,424896,52864,896,477760,425792
6640,424960,52800,896,477760,425856
6641,425024,52736,896,477760,425920
6642,425088,52672,896,477760,425984
6643,425152,52608,896,477760,426048
6644,425216,52544,896,477760,426112
6645,425280,52480,896,477760,426176
6646,425344,52416,896,477760,426240
6647,425408,52352,896,477760,426304
6648,425472,52288,896,477760,426368
6649,425536,52224,896,477760,426432
6650,425600,52160,896,477760,426496
6651,425664,52096,896,477760,426560
6652,425728,52032,896,477760,426624
6653,425792,51968,896,477760,426688
6654,425856,51904,896,477760,426752
6655,425920,51840,896,477760,426816
6656,425984,51776,896,477760,426880
6657,426048,51712,896,477760,426944
6658,426112,51648,896,477760,427008
6659,426176,51584,896,477760,427072
6660,426240,51520,896,477760,427136
6661,426304,51456,896,477760,427200
6662,426368,51392,896,477760,427264
6663,426432,51328,896,477760,427328
6664,426496,51264,896,477760,427392
6665,426560,51200,896,477760,427456
6666,426624,51136,896,477760,427520
6667,426688,51072,896,477760,427584
6668,426752,51008,896,477760,427648
6669,426816,50944,896,477760,427712
6670,426880,50880,896,477760,427776
6671,426944,50816,896,477760,427840
6672,427008,50752,896,477760,427904
6673,427072,50688,896,477760,427968
6674,427136,50624,896,477760,428032
6675,427200,50560,896,477760,428096
6676,427264,50496,896,477760,428160
6677,427328,50432,896,477760,428224
6678,427392,50368,896,477760,428288
6679,427456,50304,896,477760,428352
6680,427520,50240,896,477760,428416
6681,427584,50176,896,477760,428480
6682,427648,50112,896,477760,428544
6683,427712,50048,896,477760,428608
6684,427776,49984,896,477760,428672
6685,427840,49920,896,477760,428736
6686,427904,49856,896,477760,428800
6687,427968,49792,896,477760,428864
6688,428032,49728,896,477760,428928
6689,428096,49664,896,477760,428992
6690,428160,49600,896,477760,429056
6691,428224,49536,896,477760,429120
6692,428288,49472,896,477760,429184
6693,428352,49408,896,477760,429248
6694,428416,49344,896,477760,429312
6695,428480,49280,896,477760,429376
6696,428544,49216,896,477760,429440
6697,428608,49152,896,477760,429504
6698,428672,49088,896,477760,429568
6699,428736,49024,896,477760,429632
6700,428800,48960,896,477760,429696
6701,428864,48896,896,477760,429760
6702,428928,48832,896,477760,429824
6703,428992,48768,896,477760,429888
6704,429056,48704,896,477760,429952
6705,429120,48640,896,477760,430016
6706,429184,48576,896,477760,430080
6707,429248,48512,896,477760,430144
6708,429312,48448,896,477760,430208
6709,429376,48384,896,477760,430272
6710,429440,48320,896,477760,430336
6711,429504,48256,896,477760,430400
6712,429568,48192,896,477760,430464
6713,429632,48128,896,477760,430528
6714,429696,48064,896,477760,430592
6715,429760,48000,896,477760,430656
6716,429824,47936,896,477760,430720
6717,429888,47872,896,477760,430784
6718,429952,47808,896,477760,430848
6719,430016,47744,896,477760,430912
6720,430080,47680,896,477760,430976
6721,430144,47616,896,477760,431040
6722,430208,47552,896,477760,431104
6723,430272,47488,896,477760,431168
6724,430336,47424,896,477760,431232
6725,430400,47360,896,477760,431296
6726,430464,47296,896,477760,431360
6727,430528,47232,896,477760,431424
6728,430592,47168,896,477760,431488
6729,430656,47104,896,477760,431552
6730,430720,47040,896,477760,431616
6731,430784,46976,896,477760,431680
6732,430848,46912,896,477760,431744
6733,430912,46848,896,477760,431808
6734,430976,46784,896,477760,431872
6735,431040,46720,896,477760,431936
6736,431104,46656,896,477760,432000
6737,431168,46592,896,477760,432064
6738,431232,46528,896,477760,432128
6739,431296,46464,896,477760,432192
6740,431360,46400,896,477760,432256
6741,431424,46336,896,477760,432320
6742,431488,46272,896,477760,432384
6743,431552,46208,896,477760,432448
6744,431616,46144,896,477760,432512
6745,431680,46080,896,477760,432576
6746,431744,46016,896,477760,432640
6747,431808,45952,896,477760,432704
6748,431872,45888,896,477760,432768
6749,431936,45824,896,477760,432832
6750,432000,45760,896,477760,432896
6751,432064,45696,896,477760,432960
6752,432128,45632,896,477760,433024
6753,432192,45568,896,477760,433088
6754,432256,45504,896,477760,433152
6755,432320,45440,896,477760,433216
6756,432384,45376,896,477760,433280
6757,432448,45312,896,477760,433344
6758,432512,45248,896,477760,433408
6759,432576,45184,896,477760,433472
6760,432640,45120,896,477760,433536
6761,432704,45056,896,477760,433600
6762,432768,44992,896,477760,433664
6763,432832,44928,896,477760,433728
6764,432896,44864,896,477760,433792
6765,432960,44800,896,477760,433856
6766,433024,44736,896,477760,433920
6767,433088,44672,896,477760,433984
6768,433152,44608,896,477760,434048
6769,433216,44544,896,477760,434112
6770,433280,44480,896,477760,434176
6771,433344,44416,896,477760,434240
6772,433408,44352,896,477760,434304
6773,433472,44288,896,477760,434368
6774,433536,44224,896,477760,434432
6775,433600,44160,896,477760,434496
6776,433664,44096,896,477760,434560
6777,433728,44032,896,477760,434624
6778,433792,43968,896,477760,434688
6779,433856,43904,896,477760,434752
6780,433920,43840,896,477760,434816
6781,433984,43776,896,477760,434880
6782,434048,43712,896,477760,434944
6783,434112,43648,896,477760,435008
6784,434176,43584,896,477760,435072
6785,434240,43520,896,477760,435136
6786,434304,43456,896,477760,435200
6787,434368,43392,896,477760,435264
6788,434432,43328,896,477760,435328
6789,434496,43264,896,477760,435392
6790,434560,43200,896,477760,435456
6791,434624,43136,896,477760,435520
6792,434688,43072,896,477760,435584
6793,434752,43008,896,477760,435648
6794,434816,42944,896,477760,435712
6795,434880,42880,896,477760,435776
6796,434944,42816,896,477760,435840
6797,435008,42752,896,477760,435904
6798,435072,42688,896,477760,435968
6799,435136,42624,896,477760,436032
6800,435200,42560,896,477760,436096
6801,435264,42496,896,477760,436160
6802,435328,42432,896,477760,436224
6803,435392,42368,896,477760,436288
6804,435456,42304,896,477760,436352
6805,435520,42240,896,477760,436416
6806,435584,42176,896,477760,436480
6807,435648,42112,896,477760,436544
6808,435712,42048,896,477760,436608
6809,435776,41984,896,477760,436672
6810,435840,41920,896,477760,436736
6811,435904,41856,896,477760,436800
6812,435968,41792,896,477760,436864
6813,436032,41728,896,477760,436928
6814,436096,41664,896,477760,436992
6815,436160,41600,896,477760,437056
6816,436224,41536,896,477760,437120
6817,436288,41472,896,477760,437184
6818,436352,41408,896,477760,437248
6819,436416,41344,896,477760,437312
6820,436480,41280,896,477760,437376
6821,436544,41216,896,477760,437440
6822,436608,41152,896,477760,437504
6823,436672,41088,896,477760,437568
6824,436736,41024,896,477760,437632
6825,436800,40960,896,477760,437696
6826,436864,40896,896,477760,437760
6827,436928,40832,896,477760,437824
6828,436992,40768,896,477760,437888
6829,437056,40704,896,477760,437952
6830,437120,40640,896,477760,438016
6831,437184,40576,896,477760,438080
6832,437248,40512,896,477760,438144
6833,437312,40448,896,477760,438208
6834,437376,40384,896,477760,438272
6835,437440,40320,896,477760,438336
6836,437504,40256,896,477760,438400
6837,437568,40192,896,477760,438464
6838,437632,40128,896,477760,438528
6839,437696,40064,896,477760,438592
6840,437760,40000,896,477760,438656
6841,437824,39936,896,477760,438720
6842,437888,39872,896,477760,438784
6843,437952,39808,896,477760,438848
6844,438016,39744,896,477760,438912
6845,438080,39680,896,477760,438976
6846,438144,39616,896,477760,439040
6847,438208,39552,896,477760,439104
6848,438272,39488,896,477760,439168
6849,438336,39424,896,477760,439232
6850,438400,39360,896,477760,439296
6851,438464,39296,896,477760,439360
6852,438528,39232,896,477760,439424
6853,438592,39168,896,477760,439488
6854,438656,39104,896,477760,439552
6855,438720,39040,896,477760,439616
6856,438784,38976,896,477760,439680
6857,438848,38912,896,477760,439744
6858,438912,38848,896,477760,439808
6859,438976,38784,896,477760,439872
6860,439040,38720,896,477760,439936
6861,439104,38656,896,477760,440000
6862,439168,38592,896,477760,440064
6863,439232,38528,896,477760,440128
6864,439296,38464,896,477760,440192
6865,439360,38400,896,477760,440256
6866,439424,38336,896,477760,440320
6867,439488,38272,896,477760,440384
6868,439552,38208,896,477760,440448
6869,439616,38144,896,477760,440512
6870,439680,38080,896,477760,440576
6871,439744,38016,896,477760,440640
6872,439808,37952,896,477760,440704
6873,439872,37888,896,477760,440768
6874,439936,37824,896,477760,440832
6875,440000,37760,896,477760,440896
6876,440064,37696,896,477760,440960
6877,440128,37632,896,477760,441024
6878,440192,37568,896,477760,441088
6879,440256,37504,896,477760,441152
6880,440320,37440,896,477760,441216
6881,440384,37376,896,477760,441280
6882,440448,37312,896,477760,441344
6883,440512,37248,896,477760,441408
6884,440576,37184,896,477760,441472
6885,440640,37120,896,477760,441536
6886,440704,37056,896,477760,441600
6887,440768,36992,896,477760,441664
6888,440832,36928,896,477760,441728
6889,440896,36864,896,477760,441792
6890,440960,36800,896,477760,441856
6891,441024,36736,896,477760,441920
6892,441088,36672,896,477760,441984
6893,441152,36608,896,477760,442048
6894,441216,36544,896,477760,442112
6895,441280,36480,896,477760,442176
6896,441344,36416,896,477760,442240
6897,441408,36352,896,477760,442304
6898,441472,36288,896,477760,442368
6899,441536,36224,896,477760,442432
6900,441600,36160,896,477760,442496
6901,441664,36096,896,477760,442560
6902,441728,36032,896,477760,442624
6903,441792,35968,896,477760,442688
6904,441856,35904,896,477760,442752
6905,441920,35840,896,477760,442816
6906,441984,35776,896,477760,442880
6907,442048,35712,896,477760,442944
6908,442112,35648,896,477760,443008
6909,442176,35584,896,477760,443072
6910,442240,35520,896,477760,443136
6911,442304,35456,896,477760,443200
6912,442368,35392,896,477760,443264
6913,442432,35328,896,477760,443328
6914,442496,35264,896,477760,443392
6915,442560,35200,896,477760,443456
6916,442624,35136,896,477760,443520
6917,442688,35072,896,477760,443584
6918,442752,35008,896,477760,443648
6919,442816,34944,896,477760,443712
6920,442880,34880,896,477760,443776
6921,442944,34816,896,477760,443840
6922,443008,34752,896,477760,443904
6923,443072,34688,896,477760,443968
6924,443136,34624,896,477760,444032
6925,443200,34560,896,477760,444096
6926,443264,34496,896,477760,444160
6927,443328,34432,896,477760,444224
6928,443392,34368,896,477760,444288
6929,443456,34304,896,477760,444352
6930,443520,34240,896,477760,444416
6931,443584,34176,896,477760,444480
6932,443648,34112,896,477760,444544
6933,443712,34048,896,477760,444608
6934,443776,33984,896,477760,444672
6935,443840,33920,896,477760,444736
6936,443904,33856,896,477760,444800
6937,443968,33792,896,477760,444864
6938,444032,33728,896,477760,444928
6939,444096,33664,896,477760,444992
6940,444160,33600,896,477760,445056
6941,444224,33536,896,477760,445120
6942,444288,33472,896,477760,445184
6943,444352,33408,896,477760,445248
6944,444416,33344,896,477760,445312
6945,444480,33280,896,477760,445376
6946,444544,33216,896,477760,445440
6947,444608,33152,896,477760,445504
6948,444672,33088,896,477760,445568
6949,444736,33024,896,477760,445632
6950,444800,32960,896,477760,445696
6951,444864,32896,896,477760,445760
6952,444928,32832,896,477760,445824
6953,444992,32768,896,477760,445888
6954,445056,32704,896,477760,445952
6955,445120,32640,896,477760,446016
6956,445184,32576,896,477760,446080
6957,445248,32512,896,477760,446144
6958,445312,32448,896,477760,446208
6959,445376,32384,896,477760,446272
6960,445440,32320,896,477760,446336
6961,445504,32256,896,477760,446400
6962,445568,32192,896,477760,446464
6963,445632,32128,896,477760,446528
6964,445696,32064,896,477760,446592
6965,445760,32000,896,477760,446656
6966,445824,31936,896,477760,446720
6967,445888,31872,896,477760,446784
6968,445952,31808,896,477760,446848
6969,446016,31744,896,477760,446912
6970,446080,31680,896,477760,446976
6971,446144,31616,896,477760,447040
6972,446208,31552,896,477760,447104
6973,446272,31488,896,477760,447168
6974,446336,31424,896,477760,447232
6975,446400,31360,896,477760,447296
6976,446464,31296,896,477760,447360
6977,446528,31232,896,477760,447424
6978,446592,31168,896,477760,447488
6979,446656,31104,896,477760,447552
6980,446720,31040,896,477760,447616
6981,446784,30976,896,477760,447680
6982,446848,30912,896,477760,447744
6983,446912,30848,896,477760,447808
6984,446976,30784,896,477760,447872
6985,447040,30720,896,477760,447936
6986,447104,30656,896,477760,448000
6987,447168,30592,896,477760,448064
6988,447232,30528,896,477760,448128
6989,447296,30464,896,477760,448192
6990,447360,30400,896,477760,448256
6991,447424,30336,896,477760,448320
6992,447488,30272,896,477760,448384
6993,447552,30208,896,477760,448448
6994,447616,30144,896,477760,448512
6995,447680,30080,896,477760,448576
6996,447744,30016,896,477760,448640
6997,447808,29952,896,477760,448704
6998,447872,29888,896,477760,448768
6999,447936,29824,896,477760,448832
7000,448000,29760,896,477760,448896
7001,448064,29696,896,477760,448960
7002,448128,29632,896,477760,449024
7003,448192,29568,896,477760,449088
7004,448256,29504,896,477760,449152
7005,448320,29440,896,477760,449216
7006,448384,29376,896,477760,449280
7007,448448,29312,896,477760,449344
7008,448512,29248,896,477760,449408
7009,448576,29184,896,477760,449472
7010,448640,29120,896,477760,449536
7011,448704,29056,896,477760,449600
7012,448768,28992,896,477760,449664
7013,448832,28928,896,477760,449728
7014,448896,28864,896,477760,449792
7015,448960,28800,896,477760,449856
7016,449024,28736,896,477760,449920
7017,449088,28672,896,477760,449984
7018,449152,28608,896,477760,450048
7019,449216,28544,896,477760,450112
7020,449280,28480,896,477760,450176
7021,449344,28416,896,477760,450240
7022,449408,28352,896,477760,450304
7023,449472,28288,896,477760,450368
7024,449536,28224,896,477760,450432
7025,449600,28160,896,477760,450496
7026,449664,28096,896,477760,450560
7027,449728,28032,896,477760,450624
7028,449792,27968,896,477760,450688
7029,449856,27904,896,477760,450752
7030,449920,27840,896,477760,450816
7031,449984,27776,896,477760,450880
7032,450048,27712,896,477760,450944
7033,450112,27648,896,477760,451008
7034,450176,27584,896,477760,451072
7035,450240,27520,896,477760,451136
7036,450304,27456,896,477760,451200
7037,450368,27392,896,477760,451264
7038,450432,27328,896,477760,451328
7039,450496,27264,896,477760,451392
7040,450560,27200,896,477760,451456
7041,450624,27136,896,477760,451520
7042,450688,27072,896,477760,451584
7043,450752,27008,896,477760,451648
7044,450816,26944,896,477760,451712
7045,450880,26880,896,477760,451776
7046,450944,26816,896,477760,451840
7047,451008,26752,896,477760,451904
7048,451072,26688,896,477760,451968
7049,451136,26624,896,477760,452032
7050,451200,26560,896,477760,452096
7051,451264,26496,896,477760,452160
7052,451328,26432,896,477760,452224
7053,451392,26368,896,477760,452288
7054,451456,26304,896,477760,452352
7055,451520,26240,896,477760,452416
7056,451584,26176,896,477760,452480
7057,451648,26112,896,477760,452544
7058,451712,26048,896,477760,452608
7059,451776,25984,896,477760,452672
7060,451840,25920,896,477760,452736
7061,451904,25856,896,477760,452800
7062,451968,25792,896,477760,452864
7063,452032,25728,896,477760,452928
7064,452096,25664,896,477760,452992
7065,452160,25600,896,477760,453056
7066,452224,25536,896,477760,453120
7067,452288,25472,896,477760,453184
7068,452352,25408,896,477760,453248
7069,452416,25344,896,477760,453312
7070,452480,25280,896,477760,453376
7071,452544,25216,896,477760,453440
7072,452608,25152,896,477760,453504
7073,452672,25088,896,477760,453568
7074,452736,25024,896,477760,453632
7075,452800,24960,896,477760,453696
7076,452864,24896,896,477760,453760
7077,452928,24832,896,477760,453824
7078,452992,24768,896,477760,453888
7079,453056,24704,896,477760,453952
7080,453120,24640,896,477760,454016
7081,453184,24576,896,477760,454080
7082,453248,24512,896,477760,454144
7083,453312,24448,896,477760,454208
7084,453376,24384,896,477760,454272
7085,453440,24320,896,477760,454336
7086,453504,24256,896,477760,454400
7087,453568,24192,896,477760,454464
7088,453632,24128,896,477760,454528
7089,453696,24064,896,477760,454592
7090,453760,24000,896,477760,454656
7091,453824,23936,896,477760,454720
7092,453888,23872,896,477760,454784
7093,453952,23808,896,477760,454848
7094,454016,23744,896,477760,454912
7095,454080,23680,896,477760,454976
7096,454144,23616,896,477760,455040
7097,454208,23552,896,477760,455104
7098,454272,23488,896,477760,455168
7099,454336,23424,896,477760,455232
7100,454400,23360,896,477760,455296
7101,454464,23296,896,477760,455360
7102,454528,23232,896,477760,455424
7103,454592,23168,896,477760,455488
7104,454656,23104,896,477760,455552
7105,454720,23040,896,477760,455616
7106,454784,22976,896,477760,455680
7107,454848,22912,896,477760,455744
7108,454912,22848,896,477760,455808
7109,454976,22784,896,477760,455872
7110,455040,22720,896,477760,455936
7111,455104,22656,896,477760,456000
7112,455168,22592,896,477760,456064
7113,455232,22528,896,477760,456128
7114,455296,22464,896,477760,456192
7115,455360,22400,896,477760,456256
7116,455424,22336,896,477760,456320
7117,455488,22272,896,477760,456384
7118,455552,22208,896,477760,456448
7119,455616,22144,896,477760,456512
7120,455680,22080,896,477760,456576
7121,455744,22016,896,477760,456640
7122,455808,21952,896,477760,456704
7123,455872,21888,896,477760,456768
7124,455936,21824,896,477760,456832
7125,456000,21760,896,477760,456896
7126,456064,21696,896,477760,456960
7127,456128,21632,896,477760,457024
7128,456192,21568,896,477760,457088
7129,456256,21504,896,477760,457152
7130,456320,21440,896,477760,457216
7131,456384,21376,896,477760,457280
7132,456448,21312,896,477760,457344
7133,456512,21248,896,477760,457408
7134,456576,21184,896,477760,457472
7135,456640,21120,896,477760,457536
7136,456704,21056,896,477760,457600
7137,456768,20992,896,477760,457664
7138,456832,20928,896,477760,457728
7139,456896,20864,896,477760,457792
7140,456960,20800,896,477760,457856
7141,457024,20736,896,477760,457920
7142,457088,20672,896,477760,457984
7143,457152,20608,896,477760,458048
7144,457216,20544,896,477760,458112
7145,457280,20480,896,477760,458176
7146,457344,20416,896,477760,458240
7147,457408,20352,896,477760,458304
7148,457472,20288,896,477760,458368
7149,457536,20224,896,477760,458432
7150,457600,20160,896,477760,458496
7151,457664,20096,896,477760,458560
7152,457728,20032,896,477760,458624
7153,457792,19968,896,477760,458688
7154,457856,19904,896,477760,458752
7155,457920,19840,896,477760,458816
7156,457984,19776,896,477760,458880
7157,458048,19712,896,477760,458944
7158,458112,19648,896,477760,459008
7159,458176,19584,896,477760,459072
7160,458240,19520,896,477760,459136
7161,458304,19456,896,477760,459200
7162,458368,19392,896,477760,459264
7163,458432,19328,896,477760,459328
7164,458496,19264,896,477760,459392
7165,458560,19200,896,477760,459456
7166,458624,19136,896,477760,459520
7167,458688,19072,896,477760,459584
7168,458752,19008,896,477760,459648
7169,458816,18944,896,477760,459712
7170,458880,18880,896,477760,459776
7171,458944,18816,896,477760,459840
7172,459008,18752,896,477760,459904
7173,459072,18688,896,477760,459968
7174,459136,18624,896,477760,460032
7175,459200,18560,896,477760,460096
7176,459264,18496,896,477760,460160
7177,459328,18432,896,477760,460224
7178,459392,18368,896,477760,460288
7179,459456,18304,896,477760,460352
7180,459520,18240,896,477760,460416
7181,459584,18176,896,477760,460480
7182,459648,18112,896,477760,460544
7183,459712,18048,896,477760,460608
7184,459776,17984,896,477760,460672
7185,459840,17920,896,477760,460736
7186,459904,17856,896,477760,460800
7187,459968,17792,896,477760,460864
7188,460032,17728,896,477760,460928
7189,460096,17664,896,477760,460992
7190,460160,17600,896,477760,461056
7191,460224,17536,896,477760,461120
7192,460288,17472,896,477760,461184
7193,460352,17408,896,477760,461248
7194,460416,17344,896,477760,461312
7195,460480,17280,896,477760,461376
7196,460544,17216,896,477760,461440
7197,460608,17152,896,477760,461504
7198,460672,17088,896,477760,461568
7199,460736,17024,896,477760,461632
7200,460800,16960,896,477760,461696
7201,460864,16896,896,477760,461760
7202,460928,16832,896,477760,461824
7203,460992,16768,896,477760,461888
7204,461056,16704,896,477760,461952
7205,461120,16640,896,477760,462016
7206,461184,16576,896,477760,462080
7207,461248,16512,896,477760,462144
7208,461312,16448,896,477760,462208
7209,461376,16384,896,477760,462272
7210,461440,16320,896,477760,462336
7211,461504,16256,896,477760,462400
7212,461568,16192,896,477760,462464
7213,461632,16128,896,477760,462528
7214,461696,16064,896,477760,462592
7215,461760,16000,896,477760,462656
7216,461824,15936,896,477760,462720
7217,461888,15872,896,477760,462784
7218,461952,15808,896,477760,462848
7219,462016,15744,896,477760,462912
7220,462080,15680,896,477760,462976
7221,462144,15616,896,477760,463040
7222,462208,15552,896,477760,463104
7223,462272,15488,896,477760,463168
7224,462336,15424,896,477760,463232
7225,462400,15360,896,477760,463296
7226,462464,15296,896,477760,463360
7227,462528,15232,896,477760,463424
7228,462592,15168,896,477760,463488
7229,462656,15104,896,477760,463552
7230,462720,15040,896,477760,463616
7231,462784,14976,896,477760,463680
7232,462848,14912,896,477760,463744
7233,462912,14848,896,477760,463808
7234,462976,14784,896,477760,463872
7235,463040,14720,896,477760,463936
7236,463104,14656,896,477760,464000
7237,463168,14592,896,477760,464064
7238,463232,14528,896,477760,464128
7239,463296,14464,896,477760,464192
7240,463360,14400,896,477760,464256
7241,463424,14336,896,477760,464320
7242,463488,14272,896,477760,464384
7243,463552,14208,896,477760,464448
7244,463616,14144,896,477760,464512
7245,463680,14080,896,477760,464576
7246,463744,14016,896,477760,464640
7247,463808,13952,896,477760,464704
7248,463872,13888,896,477760,464768
7249,463936,13824,896,477760,464832
7250,464000,13760,896,477760,464896
7251,464064,13696,896,477760,464960
7252,464128,13632,896,477760,465024
7253,464192,13568,896,477760,465088
7254,464256,13504,896,477760,465152
7255,464320,13440,896,477760,465216
7256,464384,13376,896,477760,465280
7257,464448,13312,896,477760,465344
7258,464512,13248,896,477760,465408
7259,464576,13184,896,477760,465472
7260,464640,13120,896,477760,465536
7261,464704,13056,896,477760,465600
7262,464768,12992,896,477760,465664
7263,464832,12928,896,477760,465728
7264,464896,12864,896,477760,465792
7265,464960,12800,896,477760,465856
7266,465024,12736,896,477760,465920
7267,465088,12672,896,477760,465984
7268,465152,12608,896,477760,466048
7269,465216,12544,896,477760,466112
7270,465280,12480,896,477760,466176
7271,465344,12416,896,477760,466240
7272,465408,12352,896,477760,466304
7273,465472,12288,896,477760,466368
7274,465536,12224,896,477760,466432
7275,465600,12160,896,477760,466496
7276,465664,12096,896,477760,466560
7277,465728,12032,896,477760,466624
7278,465792,11968,896,477760,466688
7279,465856,11904,896,477760,466752
7280,465920,11840,896,477760,466816
7281,465984,11776,896,477760,466880
7282,466048,11712,896,477760,466944
7283,466112,11648,896,477760,467008
7284,466176,11584,896,477760,467072
7285,466240,11520,896,477760,467136
7286,466304,11456,896,477760,467200
7287,466368,11392,896,477760,467264
7288,466432,11328,896,477760,467328
7289,466496,11264,896,477760,467392
7290,466560,11200,896,477760,467456
7291,466624,11136,896,477760,467520
7292,466688,11072,896,477760,467584
7293,466752,11008,896,477760,467648
7294,466816,10944,896,477760,467712
7295,466880,10880,896,477760,467776
7296,466944,10816,896,477760,467840
7297,467008,10752,896,477760,467904
7298,467072,10688,896,477760,467968
7299,467136,10624,896,477760,468032
7300,467200,10560,896,477760,468096
7301,467264,10496,896,477760,468160
7302,467328,10432,896,477760,468224
7303,467392,10368,896,477760,468288
7304,467456,10304,896,477760,468352
7305,467520,10240,896,477760,468416
7306,467584,10176,896,477760,468480
7307,467648,10112,896,477760,468544
7308,467712,10048,896,477760,468608
7309,467776,9984,896,477760,468672
7310,467840,9920,896,477760,468736
7311,467904,9856,896,477760,468800
7312,467968,9792,896,477760,468864
7313,468032,9728,896,477760,468928
7314,468096,9664,896,477760,468992
7315,468160,9600,896,477760,469056
7316,468224,9536,896,477760,469120
7317,468288,9472,896,477760,469184
7318,468352,9408,896,477760,469248
7319,468416,9344,896,477760,469312
7320,468480,9280,896,477760,469376
7321,468544,9216,896,477760,469440
7322,468608,9152,896,477760,469504
7323,468672,9088,896,477760,469568
7324,468736,9024,896,477760,469632
7325,468800,8960,896,477760,469696
7326,468864,8896,896,477760,469760
7327,468928,8832,896,477760,469824
7328,468992,8768,896,477760,469888
7329,469056,8704,896,477760,469952
7330,469120,8640,896,477760,470016
7331,469184,8576,896,477760,470080
7332,469248,8512,896,477760,470144
7333,469312,8448,896,477760,470208
7334,469376,8384,896,477760,470272
7335,469440,8320,896,477760,470336
7336,469504,8256,896,477760,470400
7337,469568,8192,896,477760,470464
7338,469632,8128,896,477760,470528
7339,469696,8064,896,477760,470592
7340,469760,8000,896,477760,470656
7341,469824,7936,896,477760,470720
7342,469888,7872,896,477760,470784
7343,469952,7808,896,477760,470848
7344,470016,7744,896,477760,470912
7345,470080,7680,896,477760,470976
7346,470144,7616,896,477760,471040
7347,470208,7552,896,477760,471104
7348,470272,7488,896,477760,471168
7349,470336,7424,896,477760,471232
7350,470400,7360,896,477760,471296
7351,470464,7296,896,477760,471360
7352,470528,7232,896,477760,471424
7353,470592,7168,896,477760,471488
7354,470656,7104,896,477760,471552
7355,470720,7040,896,477760,471616
7356,470784,6976,896,477760,471680
7357,470848,6912,896,477760,471744
7358,470912,6848,896,477760,471808
7359,470976,6784,896,477760,471872
7360,471040,6720,896,477760,471936
7361,471104,6656,896,477760,472000
7362,471168,6592,896,477760,472064
7363,471232,6528,896,477760,472128
7364,471296,6464,896,477760,472192
7365,471360,6400,896,477760,472256
7366,471424,6336,896,477760,472320
7367,471488,6272,896,477760,472384
7368,471552,6208,896,477760,472448
7369,471616,6144,896,477760,472512
7370,471680,6080,896,477760,472576
7371,471744,6016,896,477760,472640
7372,471808,5952,896,477760,472704
7373,471872,5888,896,477760,472768
7374,471936,5824,896,477760,472832
7375,472000,5760,896,477760,472896
7376,472064,5696,896,477760,472960
7377,472128,5632,896,477760,473024
7378,472192,5568,896,477760,473088
7379,472256,5504,896,477760,473152
7380,472320,5440,896,477760,473216
7381,472384,5376,896,477760,473280
7382,472448,5312,896,477760,473344
7383,472512,5248,896,477760,473408
7384,472576,5184,896,477760,473472
7385,472640,5120,896,477760,473536
7386,472704,5056,896,477760,473600
7387,472768,4992,896,477760,473664
7388,472832,4928,896,477760,473728
7389,472896,4864,896,477760,473792
7390,472960,4800,896,477760,473856
7391,473024,4736,896,477760,473920
7392,473088,4672,896,477760,473984
7393,473152,4608,896,477760,474048
7394,473216,4544,896,477760,474112
7395,473280,4480,896,477760,474176
7396,473344,4416,896,477760,474240
7397,473408,4352,896,477760,474304
7398,473472,4288,896,477760,474368
7399,473536,4224,896,477760,474432
7400,473600,4160,896,477760,474496
7401,473664,4096,896,477760,474560
7402,473728,4032,896,477760,474624
7403,473792,3968,896,477760,474688
7404,473856,3904,896,477760,474752
7405,473920,3840,896,477760,474816
7406,473984,3776,896,477760,474880
7407,474048,3712,896,477760,474944
7408,474112,3648,896,477760,475008
7409,474176,3584,896,477760,475072
7410,474240,3520,896,477760,475136
7411,474304,3456,896,477760,475200
7412,474368,3392,896,477760,475264
7413,474432,3328,896,477760,475328
7414,474496,3264,896,477760,475392
7415,474560,3200,896,477760,475456
7416,474624,3136,896,477760,475520
7417,474688,3072,896,477760,475584
7418,474752,3008,896,477760,475648
7419,474816,2944,896,477760,475712
7420,474880,2880,896,477760,475776
7421,474944,2816,896,477760,475840
7422,475008,2752,896,477760,475904
7423,475072,2688,896,477760,475968
7424,475136,2624,896,477760,476032
7425,475200,2560,896,477760,476096
7426,475264,2496,896,477760,476160
7427,475328,2432,896,477760,476224
7428,475392,2368,896,477760,476288
7429,475456,2304,896,477760,476352
7430,475520,2240,896,477760,476416
7431,475584,2176,896,477760,476480
7432,475648,2112,896,477760,476544
7433,475712,2048,896,477760,476608
7434,475776,1984,896,477760,476672
7435,475840,1920,896,477760,476736
7436,475904,1856,896,477760,476800
7437,475968,1792,896,477760,476864
7438,476032,1728,896,477760,476928
7439,476096,1664,896,477760,476992
7440,476160,1600,896,477760,477056
7441,476224,1536,896,477760,477120
7442,476288,1472,896,477760,477184
7443,476352,1408,896,477760,477248
7444,476416,1344,896,477760,477312
7445,476480,1280,896,477760,477376
7446,476544,1216,896,477760,477440
7447,476608,1152,896,477760,477504
7448,476672,1088,896,477760,477568
7449,476736,1024,896,477760,477632
7450,476800,960,896,477760,477696
7451,476864,896,896,477760,477760
7452,476928,832,896,477760,477824
7453,476992,768,896,477760,477888
7454,477056,704,896,477760,477952
7455,477120,640,896,477760,478016
7456,477184,576,896,477760,478080
7457,477248,512,896,477760,478144
7458,477312,448,896,477760,478208
7459,477376,384,896,477760,478272
7460,477440,320,896,477760,478336
7461,477504,60160,896,537664,478400
7462,477568,60096,896,537664,478464
7463,477632,60032,896,537664,478528
7464,477696,59968,896,537664,478592
7465,477760,59904,896,537664,478656
7466,477824,59840,896,537664,478720
7467,477888,59776,896,537664,478784
7468,477952,59712,896,537664,478848
7469,478016,59648,896,537664,478912
7470,478080,59584,896,537664,478976
7471,478144,59520,896,537664,479040
7472,478208,59456,896,537664,479104
7473,478272,59392,896,537664,479168
7474,478336,59328,896,537664,479232
7475,478400,59264,896,537664,479296
7476,478464,59200,896,537664,479360
7477,478528,59136,896,537664,479424
7478,478592,59072,896,537664,479488
7479,478656,59008,896,537664,479552
7480,478720,58944,896,537664,479616
7481,478784,58880,896,537664,479680
7482,478848,58816,896,537664,479744
7483,478912,58752,896,537664,479808
7484,478976,58688,896,537664,479872
7485,479040,58624,896,537664,479936
7486,479104,58560,896,537664,480000
7487,479168,58496,896,537664,480064
7488,479232,58432,896,537664,480128
7489,479296,58368,896,537664,480192
7490,479360,58304,896,537664,480256
7491,479424,58240,896,537664,480320
7492,479488,58176,896,537664,480384
7493,479552,58112,896,537664,480448
7494,479616,58048,896,537664,480512
7495,479680,57984,896,537664,480576
7496,479744,57920,896,537664,480640
7497,479808,57856,896,537664,480704
7498,479872,57792,896,537664,480768
7499,479936,57728,896,537664,480832
7500,480000,57664,896,537664,480896
7501,480064,57600,896,537664,480960
7502,480128,57536,896,537664,481024
7503,480192,57472,896,537664,481088
7504,480256,57408,896,537664,481152
7505,480320,57344,896,537664,481216
7506,480384,57280,896,537664,481280
7507,480448,57216,896,537664,481344
7508,480512,57152,896,537664,481408
7509,480576,57088,896,537664,481472
7510,480640,57024,896,537664,481536
7511,480704,56960,896,537664,481600
7512,480768,56896,896,537664,481664
7513,480832,56832,896,537664,481728
7514,480896,56768,896,537664,481792
7515,480960,56704,896,537664,481856
7516,481024,56640,896,537664,481920
7517,481088,56576,896,537664,481984
7518,481152,56512,896,537664,482048
7519,481216,56448,896,537664,482112
7520,481280,56384,896,537664,482176
7521,481344,56320,896,537664,482240
7522,481408,56256,896,537664,482304
7523,481472,56192,896,537664,482368
7524,481536,56128,896,537664,482432
7525,481600,56064,896,537664,482496
7526,481664,56000,896,537664,482560
7527,481728,55936,896,537664,482624
7528,481792,55872,896,537664,482688
7529,481856,55808,896,537664,482752
7530,481920,55744,896,537664,482816
7531,481984,55680,896,537664,482880
7532,482048,55616,896,537664,482944
7533,482112,55552,896,537664,483008
7534,482176,55488,896,537664,483072
7535,482240,55424,896,537664,483136
7536,482304,55360,896,537664,483200
7537,482368,55296,896,537664,483264
7538,482432,55232,896,537664,483328
7539,482496,55168,896,537664,483392
7540,482560,55104,896,537664,483456
7541,482624,55040,896,537664,483520
7542,482688,54976,896,537664,483584
7543,482752,54912,896,537664,483648
7544,482816,54848,896,537664,483712
7545,482880,54784,896,537664,483776
7546,482944,54720,896,537664,483840
7547,483008,54656,896,537664,483904
7548,483072,54592,896,537664,483968
7549,483136,54528,896,537664,484032
7550,483200,54464,896,537664,484096
7551,483264,54400,896,537664,484160
7552,483328,54336,896,537664,484224
7553,483392,54272,896,537664,484288
7554,483456,54208,896,537664,484352
7555,483520,54144,896,537664,484416
7556,483584,54080,896,537664,484480
7557,483648,54016,896,537664,484544
7558,483712,53952,896,537664,484608
7559,483776,53888,896,537664,484672
7560,483840,53824,896,537664,484736
7561,483904,53760,896,537664,484800
7562,483968,53696,896,537664,484864
7563,484032,53632,896,537664,484928
7564,484096,53568,896,537664,484992
7565,484160,53504,896,537664,485056
7566,484224,53440,896,537664,485120
7567,484288,53376,896,537664,485184
7568,484352,53312,896,537664,485248
7569,484416,53248,896,537664,485312
7570,484480,53184,896,537664,485376
7571,484544,53120,896,537664,485440
7572,484608,53056,896,537664,485504
7573,484672,52992,896,537664,485568
7574,484736,52928,896,537664,485632
7575,484800,52864,896,537664,485696
7576,484864,52800,896,537664,485760
7577,484928,52736,896,537664,485824
7578,484992,52672,896,537664,485888
7579,485056,52608,896,537664,485952
7580,485120,52544,896,537664,486016
7581,485184,52480,896,537664,486080
7582,485248,52416,896,537664,486144
7583,485312,52352,896,537664,486208
7584,485376,52288,896,537664,486272
7585,485440,52224,896,537664,486336
7586,485504,52160,896,537664,486400
7587,485568,52096,896,537664,486464
7588,485632,52032,896,537664,486528
7589,485696,51968,896,537664,486592
7590,485760,51904,896,537664,486656
7591,485824,51840,896,537664,486720
7592,485888,51776,896,537664,486784
7593,485952,51712,896,537664,486848
7594,486016,51648,896,537664,486912
7595,486080,51584,896,537664,486976
7596,486144,51520,896,537664,487040
7597,486208,51456,896,537664,487104
7598,486272,51392,896,537664,487168
7599,486336,51328,896,537664,487232
7600,486400,51264,896,537664,487296
7601,486464,51200,896,537664,487360
7602,486528,51136,896,537664,487424
7603,486592,51072,896,537664,487488
7604,486656,51008,896,537664,487552
7605,486720,50944,896,537664,487616
7606,486784,50880,896,537664,487680
7607,486848,50816,896,537664,487744
7608,486912,50752,896,537664,487808
7609,486976,50688,896,537664,487872
7610,487040,50624,896,537664,487936
7611,487104,50560,896,537664,488000
7612,487168,50496,896,537664,488064
7613,487232,50432,896,537664,488128
7614,487296,50368,896,537664,488192
7615,487360,50304,896,537664,488256
7616,487424,50240,896,537664,488320
7617,487488,50176,896,537664,488384
7618,487552,50112,896,537664,488448
7619,487616,50048,896,537664,488512
7620,487680,49984,896,537664,488576
7621,487744,49920,896,537664,488640
7622,487808,49856,896,537664,488704
7623,487872,49792,896,537664,488768
7624,487936,49728,896,537664,488832
7625,488000,49664,896,537664,488896
7626,488064,49600,896,537664,488960
7627,488128,49536,896,537664,489024
7628,488192,49472,896,537664,489088
7629,488256,49408,896,537664,489152
7630,488320,49344,896,537664,489216
7631,488384,49280,896,537664,489280
7632,488448,49216,896,537664,489344
7633,488512,49152,896,537664,489408
7634,488576,49088,896,537664,489472
7635,488640,49024,896,537664,489536
7636,488704,48960,896,537664,489600
7637,488768,48896,896,537664,489664
7638,488832,48832,896,537664,489728
7639,488896,48768,896,537664,489792
7640,488960,48704,896,537664,489856
7641,489024,48640,896,537664,489920
7642,489088,48576,896,537664,489984
7643,489152,48512,896,537664,490048
7644,489216,48448,896,537664,490112
7645,489280,48384,896,537664,490176
7646,489344,48320,896,537664,490240
7647,489408,48256,896,537664,490304
7648,489472,48192,896,537664,490368
7649,489536,48128,896,537664,490432
7650,489600,48064,896,537664,490496
7651,489664,48000,896,537664,490560
7652,489728,47936,896,537664,490624
7653,489792,47872,896,537664,490688
7654,489856,47808,896,537664,490752
7655,489920,47744,896,537664,490816
7656,489984,47680,896,537664,490880
7657,490048,47616,896,537664,490944
7658,490112,47552,896,537664,491008
7659,490176,47488,896,537664,491072
7660,490240,47424,896,537664,491136
7661,490304,47360,896,537664,491200
7662,490368,47296,896,537664,491264
7663,490432,47232,896,537664,491328
7664,490496,47168,896,537664,491392
7665,490560,47104,896,537664,491456
7666,490624,47040,896,537664,491520
7667,490688,46976,896,537664,491584
7668,490752,46912,896,537664,491648
7669,490816,46848,896,537664,491712
7670,490880,46784,896,537664,491776
7671,490944,46720,896,537664,491840
7672,491008,46656,896,537664,491904
7673,491072,46592,896,537664,491968
7674,491136,46528,896,537664,492032
7675,491200,46464,896,537664,492096
7676,491264,46400,896,537664,492160
7677,491328,46336,896,537664,492224
7678,491392,46272,896,537664,492288
7679,491456,46208,896,537664,492352
7680,491520,46144,896,537664,492416
7681,491584,46080,896,537664,492480
7682,491648,46016,896,537664,492544
7683,491712,45952,896,537664,492608
7684,491776,45888,896,537664,492672
7685,491840,45824,896,537664,492736
7686,491904,45760,896,537664,492800
7687,491968,45696,896,537664,492864
7688,492032,45632,896,537664,492928
7689,492096,45568,896,537664,492992
7690,492160,45504,896,537664,493056
7691,492224,45440,896,537664,493120
7692,492288,45376,896,537664,493184
7693,492352,45312,896,537664,493248
7694,492416,45248,896,537664,493312
7695,492480,45184,896,537664,493376
7696,492544,45120,896,537664,493440
7697,492608,45056,896,537664,493504
7698,492672,44992,896,537664,493568
7699,492736,44928,896,537664,493632
7700,492800,44864,896,537664,493696
7701,492864,44800,896,537664,493760
7702,492928,44736,896,537664,493824
7703,492992,44672,896,537664,493888
7704,493056,44608,896,537664,493952
7705,493120,44544,896,537664,494016
7706,493184,44480,896,537664,494080
7707,493248,44416,896,537664,494144
7708,493312,44352,896,537664,494208
7709,493376,44288,896,537664,494272
7710,493440,44224,896,537664,494336
7711,493504,44160,896,537664,494400
7712,493568,44096,896,537664,494464
7713,493632,44032,896,537664,494528
7714,493696,43968,896,537664,494592
7715,493760,43904,896,537664,494656
7716,493824,43840,896,537664,494720
7717,493888,43776,896,537664,494784
7718,493952,43712,896,537664,494848
7719,494016,43648,896,537664,494912
7720,494080,43584,896,537664,494976
7721,494144,43520,896,537664,495040
7722,494208,43456,896,537664,495104
7723,494272,43392,896,537664,495168
7724,494336,43328,896,537664,495232
7725,494400,43264,896,537664,495296
7726,494464,43200,896,537664,495360
7727,494528,43136,896,537664,495424
7728,494592,43072,896,537664,495488
7729,494656,43008,896,537664,495552
7730,494720,42944,896,537664,495616
7731,494784,42880,896,537664,495680
7732,494848,42816,896,537664,495744
7733,494912,42752,896,537664,495808
7734,494976,42688,896,537664,495872
7735,495040,42624,896,537664,495936
7736,495104,42560,896,537664,496000
7737,495168,42496,896,537664,496064
7738,495232,42432,896,537664,496128
7739,495296,42368,896,537664,496192
7740,495360,42304,896,537664,496256
7741,495424,42240,896,537664,496320
7742,495488,42176,896,537664,496384
7743,495552,42112,896,537664,496448
7744,495616,42048,896,537664,496512
7745,495680,41984,896,537664,496576
7746,495744,41920,896,537664,496640
7747,495808,41856,896,537664,496704
7748,495872,41792,896,537664,496768
7749,495936,41728,896,537664,496832
7750,496000,41664,896,537664,496896
7751,496064,41600,896,537664,496960
7752,496128,41536,896,537664,497024
7753,496192,41472,896,537664,497088
7754,496256,41408,896,537664,497152
7755,496320,41344,896,537664,497216
7756,496384,41280,896,537664,497280
7757,496448,41216,896,537664,497344
7758,496512,41152,896,537664,497408
7759,496576,41088,896,537664,497472
7760,496640,41024,896,537664,497536
7761,496704,40960,896,537664,497600
7762,496768,40896,896,537664,497664
7763,496832,40832,896,537664,497728
7764,496896,40768,896,537664,497792
7765,496960,40704,896,537664,497856
7766,497024,40640,896,537664,497920
7767,497088,40576,896,537664,497984
7768,497152,40512,896,537664,498048
7769,497216,40448,896,537664,498112
7770,497280,40384,896,537664,498176
7771,497344,40320,896,537664,498240
7772,497408,40256,896,537664,498304
7773,497472,40192,896,537664,498368
7774,497536,40128,896,537664,498432
7775,497600,40064,896,537664,498496
7776,497664,40000,896,537664,498560
7777,497728,39936,896,537664,498624
7778,497792,39872,896,537664,498688
7779,497856,39808,896,537664,498752
7780,497920,39744,896,537664,498816
7781,497984,39680,896,537664,498880
7782,498048,39616,896,537664,498944
7783,498112,39552,896,537664,499008
7784,498176,39488,896,537664,499072
7785,498240,39424,896,537664,499136
7786,498304,39360,896,537664,499200
7787,498368,39296,896,537664,499264
7788,498432,39232,896,537664,499328
7789,498496,39168,896,537664,499392
7790,498560,39104,896,537664,499456
7791,498624,39040,896,537664,499520
7792,498688,38976,896,537664,499584
7793,498752,38912,896,537664,499648
7794,498816,38848,896,537664,499712
7795,498880,38784,896,537664,499776
7796,498944,38720,896,537664,499840
7797,499008,38656,896,537664,499904
7798,499072,38592,896,537664,499968
7799,499136,38528,896,537664,500032
7800,499200,38464,896,537664,500096
7801,499264,38400,896,537664,500160
7802,499328,38336,896,537664,500224
7803,499392,38272,896,537664,500288
7804,499456,38208,896,537664,500352
7805,499520,38144,896,537664,500416
7806,499584,38080,896,537664,500480
7807,499648,38016,896,537664,500544
7808,499712,37952,896,537664,500608
7809,499776,37888,896,537664,500672
7810,499840,37824,896,537664,500736
7811,499904,37760,896,537664,500800
7812,499968,37696,896,537664,500864
7813,500032,37632,896,537664,500928
7814,500096,37568,896,537664,500992
7815,500160,37504,896,537664,501056
7816,500224,37440,896,537664,501120
7817,500288,37376,896,537664,501184
7818,500352,37312,896,537664,501248
7819,500416,37248,896,537664,501312
7820,500480,37184,896,537664,501376
7821,500544,37120,896,537664,501440
7822,500608,37056,896,537664,501504
7823,500672,36992,896,537664,501568
7824,500736,36928,896,537664,501632
7825,500800,36864,896,537664,501696
7826,500864,36800,896,537664,501760
7827,500928,36736,896,537664,501824
7828,500992,36672,896,537664,501888
7829,501056,36608,896,537664,501952
7830,501120,36544,896,537664,502016
7831,501184,36480,896,537664,502080
7832,501248,36416,896,537664,502144
7833,501312,36352,896,537664,502208
7834,501376,36288,896,537664,502272
7835,501440,36224,896,537664,502336
7836,501504,36160,896,537664,502400
7837,501568,36096,896,537664,502464
7838,501632,36032,896,537664,502528
7839,501696,35968,896,537664,502592
7840,501760,35904,896,537664,502656
7841,501824,35840,896,537664,502720
7842,501888,35776,896,537664,502784
7843,501952,35712,896,537664,502848
7844,502016,35648,896,537664,502912
7845,502080,35584,896,537664,502976
7846,502144,35520,896,537664,503040
7847,502208,35456,896,537664,503104
7848,502272,35392,896,537664,503168
7849,502336,35328,896,537664,503232
7850,502400,35264,896,537664,503296
7851,502464,35200,896,537664,503360
7852,502528,35136,896,537664,503424
7853,502592,35072,896,537664,503488
7854,502656,35008,896,537664,503552
7855,502720,34944,896,537664,503616
7856,502784,34880,896,537664,503680
7857,502848,34816,896,537664,503744
7858,502912,34752,896,537664,503808
7859,502976,34688,896,537664,503872
7860,503040,34624,896,537664,503936
7861,503104,34560,896,537664,504000
7862,503168,34496,896,537664,504064
7863,503232,34432,896,537664,504128
7864,503296,34368,896,537664,504192
7865,503360,34304,896,537664,504256
7866,503424,34240,896,537664,504320
7867,503488,34176,896,537664,504384
7868,503552,34112,896,537664,504448
7869,503616,34048,896,537664,504512
7870,503680,33984,896,537664,504576
7871,503744,33920,896,537664,504640
7872,503808,33856,896,537664,504704
7873,503872,33792,896,537664,504768
7874,503936,33728,896,537664,504832
7875,504000,33664,896,537664,504896
7876,504064,33600,896,537664,504960
7877,504128,33536,896,537664,505024
7878,504192,33472,896,537664,505088
7879,504256,33408,896,537664,505152
7880,504320,33344,896,537664,505216
7881,504384,33280,896,537664,505280
7882,504448,33216,896,537664,505344
7883,504512,33152,896,537664,505408
7884,504576,33088,896,537664,505472
7885,504640,33024,896,537664,505536
7886,504704,32960,896,537664,505600
7887,504768,32896,896,537664,505664
7888,504832,32832,896,537664,505728
7889,504896,32768,896,537664,505792
7890,504960,32704,896,537664,505856
7891,505024,32640,896,537664,505920
7892,505088,32576,896,537664,505984
7893,505152,32512,896,537664,506048
7894,505216,32448,896,537664,506112
7895,505280,32384,896,537664,506176
7896,505344,32320,896,537664,506240
7897,505408,32256,896,537664,506304
7898,505472,32192,896,537664,506368
7899,505536,32128,896,537664,506432
7900,505600,32064,896,537664,506496
7901,505664,32000,896,537664,506560
7902,505728,31936,896,537664,506624
7903,505792,31872,896,537664,506688
7904,505856,31808,896,537664,506752
7905,505920,31744,896,537664,506816
7906,505984,31680,896,537664,506880
7907,506048,31616,896,537664,506944
7908,506112,31552,896,537664,507008
7909,506176,31488,896,537664,507072
7910,506240,31424,896,537664,507136
7911,506304,31360,896,537664,507200
7912,506368,31296,896,537664,507264
7913,506432,31232,896,537664,507328
7914,506496,31168,896,537664,507392
7915,506560,31104,896,537664,507456
7916,506624,31040,896,537664,507520
7917,506688,30976,896,537664,507584
7918,506752,30912,896,537664,507648
7919,506816,30848,896,537664,507712
7920,506880,30784,896,537664,507776
7921,506944,30720,896,537664,507840
7922,507008,30656,896,537664,507904
7923,507072,30592,896,537664,507968
7924,507136,30528,896,537664,508032
7925,507200,30464,896,537664,508096
7926,507264,30400,896,537664,508160
7927,507328,30336,896,537664,508224
7928,507392,30272,896,537664,508288
7929,507456,30208,896,537664,508352
7930,507520,30144,896,537664,508416
7931,507584,30080,896,537664,508480
7932,507648,30016,896,537664,508544
7933,507712,29952,896,537664,508608
7934,507776,29888,896,537664,508672
7935,507840,29824,896,537664,508736
7936,507904,29760,896,537664,508800
7937,507968,29696,896,537664,508864
7938,508032,29632,896,537664,508928
7939,508096,29568,896,537664,508992
7940,508160,29504,896,537664,509056
7941,508224,29440,896,537664,509120
7942,508288,29376,896,537664,509184
7943,508352,29312,896,537664,509248
7944,508416,29248,896,537664,509312
7945,508480,29184,896,537664,509376
7946,508544,29120,896,537664,509440
7947,508608,29056,896,537664,509504
7948,508672,28992,896,537664,509568
7949,508736,28928,896,537664,509632
7950,508800,28864,896,537664,509696
7951,508864,28800,896,537664,509760
7952,508928,28736,896,537664,509824
7953,508992,28672,896,537664,509888
7954,509056,28608,896,537664,509952
7955,509120,28544,896,537664,510016
7956,509184,28480,896,537664,510080
7957,509248,28416,896,537664,510144
7958,509312,28352,896,537664,510208
7959,509376,28288,896,537664,510272
7960,509440,28224,896,537664,510336
7961,509504,28160,896,537664,510400
7962,509568,28096,896,537664,510464
7963,509632,28032,896,537664,510528
7964,509696,27968,896,537664,510592
7965,509760,27904,896,537664,510656
7966,509824,27840,896,537664,510720
7967,509888,27776,896,537664,510784
7968,509952,27712,896,537664,510848
7969,510016,27648,896,537664,510912
7970,510080,27584,896,537664,510976
7971,510144,27520,896,537664,511040
7972,510208,27456,896,537664,511104
7973,510272,27392,896,537664,511168
7974,510336,27328,896,537664,511232
7975,510400,27264,896,537664,511296
7976,510464,27200,896,537664,511360
7977,510528,27136,896,537664,511424
7978,510592,27072,896,537664,511488
7979,510656,27008,896,537664,511552
7980,510720,26944,896,537664,511616
7981,510784,26880,896,537664,511680
7982,510848,26816,896,537664,511744
7983,510912,26752,896,537664,511808
7984,510976,26688,896,537664,511872
7985,511040,26624,896,537664,511936
7986,511104,26560,896,537664,512000
7987,511168,26496,896,537664,512064
7988,511232,26432,896,537664,512128
7989,511296,26368,896,537664,512192
7990,511360,26304,896,537664,512256
7991,511424,26240,896,537664,512320
7992,511488,26176,896,537664,512384
7993,511552,26112,896,537664,512448
7994,511616,26048,896,537664,512512
7995,511680,25984,896,537664,512576
7996,511744,25920,896,537664,512640
7997,511808,25856,896,537664,512704
7998,511872,25792,896,537664,512768
7999,511936,25728,896,537664,512832
8000,512000,25664,896,537664,512896
8001,512064,25600,896,537664,512960
8002,512128,25536,896,537664,513024
8003,512192,25472,896,537664,513088
8004,512256,25408,896,537664,513152
8005,512320,25344,896,537664,513216
8006,512384,25280,896,537664,513280
8007,512448,25216,896,537664,513344
8008,512512,25152,896,537664,513408
8009,512576,25088,896,537664,513472
8010,512640,25024,896,537664,513536
8011,512704,24960,896,537664,513600
8012,512768,24896,896,537664,513664
8013,512832,24832,896,537664,513728
8014,512896,24768,896,537664,513792
8015,512960,24704,896,537664,513856
8016,513024,24640,896,537664,513920
8017,513088,24576,896,537664,513984
8018,513152,24512,896,537664,514048
8019,513216,24448,896,537664,514112
8020,513280,24384,896,537664,514176
8021,513344,24320,896,537664,514240
8022,513408,24256,896,537664,514304
8023,513472,24192,896,537664,514368
8024,513536,24128,896,537664,514432
8025,513600,24064,896,537664,514496
8026,513664,24000,896,537664,514560
8027,513728,23936,896,537664,514624
8028,513792,23872,896,537664,514688
8029,513856,23808,896,537664,514752
8030,513920,23744,896,537664,514816
8031,513984,23680,896,537664,514880
8032,514048,23616,896,537664,514944
8033,514112,23552,896,537664,515008
8034,514176,23488,896,537664,515072
8035,514240,23424,896,537664,515136
8036,514304,23360,896,537664,515200
8037,514368,23296,896,537664,515264
8038,514432,23232,896,537664,515328
8039,514496,23168,896,537664,515392
8040,514560,23104,896,537664,515456
8041,514624,23040,896,537664,515520
8042,514688,22976,896,537664,515584
8043,514752,22912,896,537664,515648
8044,514816,22848,896,537664,515712
8045,514880,22784,896,537664,515776
8046,514944,22720,896,537664,515840
8047,515008,22656,896,537664,515904
8048,515072,22592,896,537664,515968
8049,515136,22528,896,537664,516032
8050,515200,22464,896,537664,516096
8051,515264,22400,896,537664,516160
8052,515328,22336,896,537664,516224
8053,515392,22272,896,537664,516288
8054,515456,22208,896,537664,516352
8055,515520,22144,896,537664,516416
8056,515584,22080,896,537664,516480
8057,515648,22016,896,537664,516544
8058,515712,21952,896,537664,516608
8059,515776,21888,896,537664,516672
8060,515840,21824,896,537664,516736
8061,515904,21760,896,537664,516800
8062,515968,21696,896,537664,516864
8063,516032,21632,896,537664,516928
8064,516096,21568,896,537664,516992
8065,516160,21504,896,537664,517056
8066,516224,21440,896,537664,517120
8067,516288,21376,896,537664,517184
8068,516352,21312,896,537664,517248
8069,516416,21248,896,537664,517312
8070,516480,21184,896,537664,517376
8071,516544,21120,896,537664,517440
8072,516608,21056,896,537664,517504
8073,516672,20992,896,537664,517568
8074,516736,20928,896,537664,517632
8075,516800,20864,896,537664,517696
8076,516864,20800,896,537664,517760
8077,516928,20736,896,537664,517824
8078,516992,20672,896,537664,517888
8079,517056,20608,896,537664,517952
8080,517120,20544,896,537664,518016
8081,517184,20480,896,537664,518080
8082,517248,20416,896,537664,518144
8083,517312,20352,896,537664,518208
8084,517376,20288,896,537664,518272
8085,517440,20224,896,537664,518336
8086,517504,20160,896,537664,518400
8087,517568,20096,896,537664,518464
8088,517632,20032,896,537664,518528
8089,517696,19968,896,537664,518592
8090,517760,19904,896,537664,518656
8091,517824,19840,896,537664,518720
8092,517888,19776,896,537664,518784
8093,517952,19712,896,537664,518848
8094,518016,19648,896,537664,518912
8095,518080,19584,896,537664,518976
8096,518144,19520,896,537664,519040
8097,518208,19456,896,537664,519104
8098,518272,19392,896,537664,519168
8099,518336,19328,896,537664,519232
8100,518400,19264,896,537664,519296
8101,518464,19200,896,537664,519360
8102,518528,19136,896,537664,519424
8103,518592,19072,896,537664,519488
8104,518656,19008,896,537664,519552
8105,518720,18944,896,537664,519616
8106,518784,18880,896,537664,519680
8107,518848,18816,896,537664,519744
8108,518912,18752,896,537664,519808
8109,518976,18688,896,537664,519872
8110,519040,18624,896,537664,519936
8111,519104,18560,896,537664,520000
8112,519168,18496,896,537664,520064
8113,519232,18432,896,537664,520128
8114,519296,18368,896,537664,520192
8115,519360,18304,896,537664,520256
8116,519424,18240,896,537664,520320
8117,519488,18176,896,537664,520384
8118,519552,18112,896,537664,520448
8119,519616,18048,896,537664,520512
8120,519680,17984,896,537664,520576
8121,519744,17920,896,537664,520640
8122,519808,17856,896,537664,520704
8123,519872,17792,896,537664,520768
8124,519936,17728,896,537664,520832
8125,520000,17664,896,537664,520896
8126,520064,17600,896,537664,520960
8127,520128,17536,896,537664,521024
8128,520192,17472,896,537664,521088
8129,520256,17408,896,537664,521152
8130,520320,17344,896,537664,521216
8131,520384,17280,896,537664,521280
8132,520448,17216,896,537664,521344
8133,520512,17152,896,537664,521408
8134,520576,17088,896,537664,521472
8135,520640,17024,896,537664,521536
8136,520704,16960,896,537664,521600
8137,520768,16896,896,537664,521664
8138,520832,16832,896,537664,521728
8139,520896,16768,896,537664,521792
8140,520960,16704,896,537664,521856
8141,521024,16640,896,537664,521920
8142,521088,16576,896,537664,521984
8143,521152,16512,896,537664,522048
8144,521216,16448,896,537664,522112
8145,521280,16384,896,537664,522176
8146,521344,16320,896,537664,522240
8147,521408,16256,896,537664,522304
8148,521472,16192,896,537664,522368
8149,521536,16128,896,537664,522432
8150,521600,16064,896,537664,522496
8151,521664,16000,896,537664,522560
8152,521728,15936,896,537664,522624
8153,521792,15872,896,537664,522688
8154,521856,15808,896,537664,522752
8155,521920,15744,896,537664,522816
8156,521984,15680,896,537664,522880
8157,522048,15616,896,537664,522944
8158,522112,15552,896,537664,523008
8159,522176,15488,896,537664,523072
8160,522240,15424,896,537664,523136
8161,522304,15360,896,537664,523200
8162,522368,15296,896,537664,523264
8163,522432,15232,896,537664,523328
8164,522496,15168,896,537664,523392
8165,522560,15104,896,537664,523456
8166,522624,15040,896,537664,523520
8167,522688,14976,896,537664,523584
8168,522752,14912,896,537664,523648
8169,522816,14848,896,537664,523712
8170,522880,14784,896,537664,523776
8171,522944,14720,896,537664,523840
8172,523008,14656,896,537664,523904
8173,523072,14592,896,537664,523968
8174,523136,14528,896,537664,524032
8175,523200,14464,896,537664,524096
8176,523264,14400,896,537664,524160
8177,523328,14336,896,537664,524224
8178,523392,14272,896,537664,524288
8179,523456,14208,896,537664,524352
8180,523520,14144,896,537664,524416
8181,523584,14080,896,537664,524480
8182,523648,14016,896,537664,524544
8183,523712,13952,896,537664,524608
8184,523776,13888,896,537664,524672
8185,523840,13824,896,537664,524736
8186,523904,13760,896,537664,524800
8187,523968,13696,896,537664,524864
8188,524032,13632,896,537664,524928
8189,524096,13568,896,537664,524992
8190,524160,13504,896,537664,525056
8191,524224,13440,896,537664,525120
8192,524288,13376,896,537664,525184
8193,524352,13312,896,537664,525248
8194,524416,13248,896,537664,525312
8195,524480,13184,896,537664,525376
8196,524544,13120,896,537664,525440
8197,524608,13056,896,537664,525504
8198,524672,12992,896,537664,525568
8199,524736,12928,896,537664,525632
8200,524800,12864,896,537664,525696
8201,524864,12800,896,537664,525760
8202,524928,12736,896,537664,525824
8203,524992,12672,896,537664,525888
8204,525056,12608,896,537664,525952
8205,525120,12544,896,537664,526016
8206,525184,12480,896,537664,526080
8207,525248,12416,896,537664,526144
8208,525312,12352,896,537664,526208
8209,525376,12288,896,537664,526272
8210,525440,12224,896,537664,526336
8211,525504,12160,896,537664,526400
8212,525568,12096,896,537664,526464
8213,525632,12032,896,537664,526528
8214,525696,11968,896,537664,526592
8215,525760,11904,896,537664,526656
8216,525824,11840,896,537664,526720
8217,525888,11776,896,537664,526784
8218,525952,11712,896,537664,526848
8219,526016,11648,896,537664,526912
8220,526080,11584,896,537664,526976
8221,526144,11520,896,537664,527040
8222,526208,11456,896,537664,527104
8223,526272,11392,896,537664,527168
8224,526336,11328,896,537664,527232
8225,526400,11264,896,537664,527296
8226,526464,11200,896,537664,527360
8227,526528,11136,896,537664,527424
8228,526592,11072,896,537664,527488
8229,526656,11008,896,537664,527552
8230,526720,10944,896,537664,527616
8231,526784,10880,896,537664,527680
8232,526848,10816,896,537664,527744
8233,526912,10752,896,537664,527808
8234,526976,10688,896,537664,527872
8235,527040,10624,896,537664,527936
8236,527104,10560,896,537664,528000
8237,527168,10496,896,537664,528064
8238,527232,10432,896,537664,528128
8239,527296,10368,896,537664,528192
8240,527360,10304,896,537664,528256
8241,527424,10240,896,537664,528320
8242,527488,10176,896,537664,528384
8243,527552,10112,896,537664,528448
8244,527616,10048,896,537664,528512
8245,527680,9984,896,537664,528576
8246,527744,9920,896,537664,528640
8247,527808,9856,896,537664,528704
8248,527872,9792,896,537664,528768
8249,527936,9728,896,537664,528832
8250,528000,9664,896,537664,528896
8251,528064,9600,896,537664,528960
8252,528128,9536,896,537664,529024
8253,528192,9472,896,537664,529088
8254,528256,9408,896,537664,529152
8255,528320,9344,896,537664,529216
8256,528384,9280,896,537664,529280
8257,528448,9216,896,537664,529344
8258,528512,9152,896,537664,529408
8259,528576,9088,896,537664,529472
8260,528640,9024,896,537664,529536
8261,528704,8960,896,537664,529600
8262,528768,8896,896,537664,529664
8263,528832,8832,896,537664,529728
8264,528896,8768,896,537664,529792
8265,528960,8704,896,537664,529856
8266,529024,8640,896,537664,529920
8267,529088,8576,896,537664,529984
8268,529152,8512,896,537664,530048
8269,529216,8448,896,537664,530112
8270,529280,8384,896,537664,530176
8271,529344,8320,896,537664,530240
8272,529408,8256,896,537664,530304
8273,529472,8192,896,537664,530368
8274,529536,8128,896,537664,530432
8275,529600,8064,896,537664,530496
8276,529664,8000,896,537664,530560
8277,529728,7936,896,537664,530624
8278,529792,7872,896,537664,530688
8279,529856,7808,896,537664,530752
8280,529920,7744,896,537664,530816
8281,529984,7680,896,537664,530880
8282,530048,7616,896,537664,530944
8283,530112,7552,896,537664,531008
8284,530176,7488,896,537664,531072
8285,530240,7424,896,537664,531136
8286,530304,7360,896,537664,531200
8287,530368,7296,896,537664,531264
8288,530432,7232,896,537664,531328
8289,530496,7168,896,537664,531392
8290,530560,7104,896,537664,531456
8291,530624,7040,896,537664,531520
8292,530688,6976,896,537664,531584
8293,530752,6912,896,537664,531648
8294,530816,6848,896,537664,531712
8295,530880,6784,896,537664,531776
8296,530944,6720,896,537664,531840
8297,531008,6656,896,537664,531904
8298,531072,6592,896,537664,531968
8299,531136,6528,896,537664,532032
8300,531200,6464,896,537664,532096
8301,531264,6400,896,537664,532160
8302,531328,6336,896,537664,532224
8303,531392,6272,896,537664,532288
8304,531456,6208,896,537664,532352
8305,531520,6144,896,537664,532416
8306,531584,6080,896,537664,532480
8307,531648,6016,896,537664,532544
8308,531712,5952,896,537664,532608
8309,531776,5888,896,537664,532672
8310,531840,5824,896,537664,532736
8311,531904,5760,896,537664,532800
8312,531968,5696,896,537664,532864
8313,532032,5632,896,537664,532928
8314,532096,5568,896,537664,532992
8315,532160,5504,896,537664,533056
8316,532224,5440,896,537664,533120
8317,532288,5376,896,537664,533184
8318,532352,5312,896,537664,533248
8319,532416,5248,896,537664,533312
8320,532480,5184,896,537664,533376
8321,532544,5120,896,537664,533440
8322,532608,5056,896,537664,533504
8323,532672,4992,896,537664,533568
8324,532736,4928,896,537664,533632
8325,532800,4864,896,537664,533696
8326,532864,4800,896,537664,533760
8327,532928,4736,896,537664,533824
8328,532992,4672,896,537664,533888
8329,533056,4608,896,537664,533952
8330,533120,4544,896,537664,534016
8331,533184,4480,896,537664,534080
8332,533248,4416,896,537664,534144
8333,533312,4352,896,537664,534208
8334,533376,4288,896,537664,534272
8335,533440,4224,896,537664,534336
8336,533504,4160,896,537664,534400
8337,533568,4096,896,537664,534464
8338,533632,4032,896,537664,534528
8339,533696,3968,896,537664,534592
8340,533760,3904,896,537664,534656
8341,533824,3840,896,537664,534720
8342,533888,3776,896,537664,534784
8343,533952,3712,896,537664,534848
8344,534016,3648,896,537664,534912
8345,534080,3584,896,537664,534976
8346,534144,3520,896,537664,535040
8347,534208,3456,896,537664,535104
8348,534272,3392,896,537664,535168
8349,534336,3328,896,537664,535232
8350,534400,3264,896,537664,535296
8351,534464,3200,896,537664,535360
8352,534528,3136,896,537664,535424
8353,534592,3072,896,537664,535488
8354,534656,3008,896,537664,535552
8355,534720,2944,896,537664,535616
8356,534784,2880,896,537664,535680
8357,534848,2816,896,537664,535744
8358,534912,2752,896,537664,535808
8359,534976,2688,896,537664,535872
8360,535040,2624,896,537664,535936
8361,535104,2560,896,537664,536000
8362,535168,2496,896,537664,536064
8363,535232,2432,896,537664,536128
8364,535296,2368,896,537664,536192
8365,535360,2304,896,537664,536256
8366,535424,2240,896,537664,536320
8367,535488,2176,896,537664,536384
8368,535552,2112,896,537664,536448
8369,535616,2048,896,537664,536512
8370,535680,1984,896,537664,536576
8371,535744,1920,896,537664,536640
8372,535808,1856,896,537664,536704
8373,535872,1792,896,537664,536768
8374,535936,1728,896,537664,536832
8375,536000,1664,896,537664,536896
8376,536064,1600,896,537664,536960
8377,536128,1536,896,537664,537024
8378,536192,1472,896,537664,537088
8379,536256,1408,896,537664,537152
8380,536320,1344,896,537664,537216
8381,536384,1280,896,537664,537280
8382,536448,1216,896,537664,537344
8383,536512,1152,896,537664,537408
8384,536576,1088,896,537664,537472
8385,536640,1024,896,537664,537536
8386,536704,960,896,537664,537600
8387,536768,896,896,537664,537664
8388,536832,832,896,537664,537728
8389,536896,768,896,537664,537792
8390,536960,704,896,537664,537856
8391,537024,640,896,537664,537920
8392,537088,576,896,537664,537984
8393,537152,512,896,537664,538048
8394,537216,448,896,537664,538112
8395,537280,384,896,537664,538176
8396,537344,320,896,537664,538240
8397,537408,67840,896,605248,538304
8398,537472,67776,896,605248,538368
8399,537536,67712,896,605248,538432
8400,537600,67648,896,605248,538496
8401,537664,67584,896,605248,538560
8402,537728,67520,896,605248,538624
8403,537792,67456,896,605248,538688
8404,537856,67392,896,605248,538752
8405,537920,67328,896,605248,538816
8406,537984,67264,896,605248,538880
8407,538048,67200,896,605248,538944
8408,538112,67136,896,605248,539008
8409,538176,67072,896,605248,539072
8410,538240,67008,896,605248,539136
8411,538304,66944,896,605248,539200
8412,538368,66880,896,605248,539264
8413,538432,66816,896,605248,539328
8414,538496,66752,896,605248,539392
8415,538560,66688,896,605248,539456
8416,538624,66624,896,605248,539520
8417,538688,66560,896,605248,539584
8418,538752,66496,896,605248,539648
8419,538816,66432,896,605248,539712
8420,538880,66368,896,605248,539776
8421,538944,66304,896,605248,539840
8422,539008,66240,896,605248,539904
8423,539072,66176,896,605248,539968
8424,539136,66112,896,605248,540032
8425,539200,66048,896,605248,540096
8426,539264,65984,896,605248,540160
8427,539328,65920,896,605248,540224
8428,539392,65856,896,605248,540288
8429,539456,65792,896,605248,540352
8430,539520,65728,896,605248,540416
8431,539584,65664,896,605248,540480
8432,539648,65600,896,605248,540544
8433,539712,65536,896,605248,540608
8434,539776,65472,896,605248,540672
8435,539840,65408,896,605248,540736
8436,539904,65344,896,605248,540800
8437,539968,65280,896,605248,540864
8438,540032,65216,896,605248,540928
8439,540096,65152,896,605248,540992
8440,540160,65088,896,605248,541056
8441,540224,65024,896,605248,541120
8442,540288,64960,896,605248,541184
8443,540352,64896,896,605248,541248
8444,540416,64832,896,605248,541312
8445,540480,64768,896,605248,541376
8446,540544,64704,896,605248,541440
8447,540608,64640,896,605248,541504
8448,540672,64576,896,605248,541568
8449,540736,64512,896,605248,541632
8450,540800,64448,896,605248,541696
8451,540864,64384,896,605248,541760
8452,540928,64320,896,605248,541824
8453,540992,64256,896,605248,541888
8454,541056,64192,896,605248,541952
8455,541120,64128,896,605248,542016
8456,541184,64064,896,605248,542080
8457,541248,64000,896,605248,542144
8458,541312,63936,896,605248,542208
8459,541376,63872,896,605248,542272
8460,541440,63808,896,605248,542336
8461,541504,63744,896,605248,542400
8462,541568,63680,896,605248,542464
8463,541632,63616,896,605248,542528
8464,541696,63552,896,605248,542592
8465,541760,63488,896,605248,542656
8466,541824,63424,896,605248,542720
8467,541888,63360,896,605248,542784
8468,541952,63296,896,605248,542848
8469,542016,63232,896,605248,542912
8470,542080,63168,896,605248,542976
8471,542144,63104,896,605248,543040
8472,542208,63040,896,605248,543104
8473,542272,62976,896,605248,543168
8474,542336,62912,896,605248,543232
8475,542400,62848,896,605248,543296
8476,542464,62784,896,605248,543360
8477,542528,62720,896,605248,543424
8478,542592,62656,896,605248,543488
8479,542656,62592,896,605248,543552
8480,542720,62528,896,605248,543616
8481,542784,62464,896,605248,543680
8482,542848,62400,896,605248,543744
8483,542912,62336,896,605248,543808
8484,542976,62272,896,605248,543872
8485,543040,62208,896,605248,543936
8486,543104,62144,896,605248,544000
8487,543168,62080,896,605248,544064
8488,543232,62016,896,605248,544128
8489,543296,61952,896,605248,544192
8490,543360,61888,896,605248,544256
8491,543424,61824,896,605248,544320
8492,543488,61760,896,605248,544384
8493,543552,61696,896,605248,544448
8494,543616,61632,896,605248,544512
8495,543680,61568,896,605248,544576
8496,543744,61504,896,605248,544640
8497,543808,61440,896,605248,544704
8498,543872,61376,896,605248,544768
8499,543936,61312,896,605248,544832
8500,544000,61248,896,605248,544896
8501,544064,61184,896,605248,544960
8502,544128,61120,896,605248,545024
8503,544192,61056,896,605248,545088
8504,544256,60992,896,605248,545152
8505,544320,60928,896,605248,545216
8506,544384,60864,896,605248,545280
8507,544448,60800,896,605248,545344
8508,544512,60736,896,605248,545408
8509,544576,60672,896,605248,545472
8510,544640,60608,896,605248,545536
8511,544704,60544,896,605248,545600
8512,544768,60480,896,605248,545664
8513,544832,60416,896,605248,545728
8514,544896,60352,896,605248,545792
8515,544960,60288,896,605248,545856
8516,545024,60224,896,605248,545920
8517,545088,60160,896,605248,545984
8518,545152,60096,896,605248,546048
8519,545216,60032,896,605248,546112
8520,545280,59968,896,605248,546176
8521,545344,59904,896,605248,546240
8522,545408,59840,896,605248,546304
8523,545472,59776,896,605248,546368
8524,545536,59712,896,605248,546432
8525,545600,59648,896,605248,546496
8526,545664,59584,896,605248,546560
8527,545728,59520,896,605248,546624
8528,545792,59456,896,605248,546688
8529,545856,59392,896,605248,546752
8530,545920,59328,896,605248,546816
8531,545984,59264,896,605248,546880
8532,546048,59200,896,605248,546944
8533,546112,59136,896,605248,547008
8534,546176,59072,896,605248,547072
8535,546240,59008,896,605248,547136
8536,546304,58944,896,605248,547200
8537,546368,58880,896,605248,547264
8538,546432,58816,896,605248,547328
8539,546496,58752,896,605248,547392
8540,546560,58688,896,605248,547456
8541,546624,58624,896,605248,547520
8542,546688,58560,896,605248,547584
8543,546752,58496,896,605248,547648
8544,546816,58432,896,605248,547712
8545,546880,58368,896,605248,547776
8546,546944,58304,896,605248,547840
8547,547008,58240,896,605248,547904
8548,547072,58176,896,605248,547968
8549,547136,58112,896,605248,548032
8550,547200,58048,896,605248,548096
8551,547264,57984,896,605248,548160
8552,547328,57920,896,605248,548224
8553,547392,57856,896,605248,548288
8554,547456,57792,896,605248,548352
8555,547520,57728,896,605248,548416
8556,547584,57664,896,605248,548480
8557,547648,57600,896,605248,548544
8558,547712,57536,896,605248,548608
8559,547776,57472,896,605248,548672
8560,547840,57408,896,605248,548736
8561,547904,57344,896,605248,548800
8562,547968,57280,896,605248,548864
8563,548032,57216,896,605248,548928
8564,548096,57152,896,605248,548992
8565,548160,57088,896,605248,549056
8566,548224,57024,896,605248,549120
8567,548288,56960,896,605248,549184
8568,548352,56896,896,605248,549248
8569,548416,56832,896,605248,549312
8570,548480,56768,896,605248,549376
8571,548544,56704,896,605248,549440
8572,548608,56640,896,605248,549504
8573,548672,56576,896,605248,549568
8574,548736,56512,896,605248,549632
8575,548800,56448,896,605248,549696
8576,548864,56384,896,605248,549760
8577,548928,56320,896,605248,549824
8578,548992,56256,896,605248,549888
8579,549056,56192,896,605248,549952
8580,549120,56128,896,605248,550016
8581,549184,56064,896,605248,550080
8582,549248,56000,896,605248,550144
8583,549312,55936,896,605248,550208
8584,549376,55872,896,605248,550272
8585,549440,55808,896,605248,550336
8586,549504,55744,896,605248,550400
8587,549568,55680,896,605248,550464
8588,549632,55616,896,605248,550528
8589,549696,55552,896,605248,550592
8590,549760,55488,896,605248,550656
8591,549824,55424,896,605248,550720
8592,549888,55360,896,605248,550784
8593,549952,55296,896,605248,550848
8594,550016,55232,896,605248,550912
8595,550080,55168,896,605248,550976
8596,550144,55104,896,605248,551040
8597,550208,55040,896,605248,551104
8598,550272,54976,896,605248,551168
8599,550336,54912,896,605248,551232
8600,550400,54848,896,605248,551296
8601,550464,54784,896,605248,551360
8602,550528,54720,896,605248,551424
8603,550592,54656,896,605248,551488
8604,550656,54592,896,605248,551552
8605,550720,54528,896,605248,551616
8606,550784,54464,896,605248,551680
8607,550848,54400,896,605248,551744
8608,550912,54336,896,605248,551808
8609,550976,54272,896,605248,551872
8610,551040,54208,896,605248,551936
8611,551104,54144,896,605248,552000
8612,551168,54080,896,605248,552064
8613,551232,54016,896,605248,552128
8614,551296,53952,896,605248,552192
8615,551360,53888,896,605248,552256
8616,551424,53824,896,605248,552320
8617,551488,53760,896,605248,552384
8618,551552,53696,896,605248,552448
8619,551616,53632,896,605248,552512
8620,551680,53568,896,605248,552576
8621,551744,53504,896,605248,552640
8622,551808,53440,896,605248,552704
8623,551872,53376,896,605248,552768
8624,551936,53312,896,605248,552832
8625,552000,53248,896,605248,552896
8626,552064,53184,896,605248,552960
8627,552128,53120,896,605248,553024
8628,552192,53056,896,605248,553088
8629,552256,52992,896,605248,553152
8630,552320,52928,896,605248,553216
8631,552384,52864,896,605248,553280
8632,552448,52800,896,605248,553344
8633,552512,52736,896,605248,553408
8634,552576,52672,896,605248,553472
8635,552640,52608,896,605248,553536
8636,552704,52544,896,605248,553600
8637,552768,52480,896,605248,553664
8638,552832,52416,896,605248,553728
8639,552896,52352,896,605248,553792
8640,552960,52288,896,605248,553856
8641,553024,52224,896,605248,553920
8642,553088,52160,896,605248,553984
8643,553152,52096,896,605248,554048
8644,553216,52032,896,605248,554112
8645,553280,51968,896,605248,554176
8646,553344,51904,896,605248,554240
8647,553408,51840,896,605248,554304
8648,553472,51776,896,605248,554368
8649,553536,51712,896,605248,554432
8650,553600,51648,896,605248,554496
8651,553664,51584,896,605248,554560
8652,553728,51520,896,605248,554624
8653,553792,51456,896,605248,554688
8654,553856,51392,896,605248,554752
8655,553920,51328,896,605248,554816
8656,553984,51264,896,605248,554880
8657,554048,51200,896,605248,554944
8658,554112,51136,896,605248,555008
8659,554176,51072,896,605248,555072
8660,554240,51008,896,605248,555136
8661,554304,50944,896,605248,555200
8662,554368,50880,896,605248,555264
8663,554432,50816,896,605248,555328
8664,554496,50752,896,605248,555392
8665,554560,50688,896,605248,555456
8666,554624,50624,896,605248,555520
8667,554688,50560,896,605248,555584
8668,554752,50496,896,605248,555648
8669,554816,50432,896,605248,555712
8670,554880,50368,896,605248,555776
8671,554944,50304,896,605248,555840
8672,555008,50240,896,605248,555904
8673,555072,50176,896,605248,555968
8674,555136,50112,896,605248,556032
8675,555200,50048,896,605248,556096
8676,555264,49984,896,605248,556160
8677,555328,49920,896,605248,556224
8678,555392,49856,896,605248,556288
8679,555456,49792,896,605248,556352
8680,555520,49728,896,605248,556416
8681,555584,49664,896,605248,556480
8682,555648,49600,896,605248,556544
8683,555712,49536,896,605248,556608
8684,555776,49472,896,605248,556672
8685,555840,49408,896,605248,556736
8686,555904,49344,896,605248,556800
8687,555968,49280,896,605248,556864
8688,556032,49216,896,605248,556928
8689,556096,49152,896,605248,556992
8690,556160,49088,896,605248,557056
8691,556224,49024,896,605248,557120
8692,556288,48960,896,605248,557184
8693,556352,48896,896,605248,557248
8694,556416,48832,896,605248,557312
8695,556480,48768,896,605248,557376
8696,556544,48704,896,605248,557440
8697,556608,48640,896,605248,557504
8698,556672,48576,896,605248,557568
8699,556736,48512,896,605248,557632
8700,556800,48448,896,605248,557696
8701,556864,48384,896,605248,557760
8702,556928,48320,896,605248,557824
8703,556992,48256,896,605248,557888
8704,557056,48192,896,605248,557952
8705,557120,48128,896,605248,558016
8706,557184,48064,896,605248,558080
8707,557248,48000,896,605248,558144
8708,557312,47936,896,605248,558208
8709,557376,47872,896,605248,558272
8710,557440,47808,896,605248,558336
8711,557504,47744,896,605248,558400
8712,557568,47680,896,605248,558464
8713,557632,47616,896,605248,558528
8714,557696,47552,896,605248,558592
8715,557760,47488,896,605248,558656
8716,557824,47424,896,605248,558720
8717,557888,47360,896,605248,558784
8718,557952,47296,896,605248,558848
8719,558016,47232,896,605248,558912
8720,558080,47168,896,605248,558976
8721,558144,47104,896,605248,559040
8722,558208,47040,896,605248,559104
8723,558272,46976,896,605248,559168
8724,558336,46912,896,605248,559232
8725,558400,46848,896,605248,559296
8726,558464,46784,896,605248,559360
8727,558528,46720,896,605248,559424
8728,558592,46656,896,605248,559488
8729,558656,46592,896,605248,559552
8730,558720,46528,896,605248,559616
8731,558784,46464,896,605248,559680
8732,558848,46400,896,605248,559744
8733,558912,46336,896,605248,559808
8734,558976,46272,896,605248,559872
8735,559040,46208,896,605248,559936
8736,559104,46144,896,605248,560000
8737,559168,46080,896,605248,560064
8738,559232,46016,896,605248,560128
8739,559296,45952,896,605248,560192
8740,559360,45888,896,605248,560256
8741,559424,45824,896,605248,560320
8742,559488,45760,896,605248,560384
8743,559552,45696,896,605248,560448
8744,559616,45632,896,605248,560512
8745,559680,45568,896,605248,560576
8746,559744,45504,896,605248,560640
8747,559808,45440,896,605248,560704
8748,559872,45376,896,605248,560768
8749,559936,45312,896,605248,560832
8750,560000,45248,896,605248,560896
8751,560064,45184,896,605248,560960
8752,560128,45120,896,605248,561024
8753,560192,45056,896,605248,561088
8754,560256,44992,896,605248,561152
8755,560320,44928,896,605248,561216
8756,560384,44864,896,605248,561280
8757,560448,44800,896,605248,561344
8758,560512,44736,896,605248,561408
8759,560576,44672,896,605248,561472
8760,560640,44608,896,605248,561536
8761,560704,44544,896,605248,561600
8762,560768,44480,896,605248,561664
8763,560832,44416,896,605248,561728
8764,560896,44352,896,605248,561792
8765,560960,44288,896,605248,561856
8766,561024,44224,896,605248,561920
8767,561088,44160,896,605248,561984
8768,561152,44096,896,605248,562048
8769,561216,44032,896,605248,562112
8770,561280,43968,896,605248,562176
8771,561344,43904,896,605248,562240
8772,561408,43840,896,605248,562304
8773,561472,43776,896,605248,562368
8774,561536,43712,896,605248,562432
8775,561600,43648,896,605248,562496
8776,561664,43584,896,605248,562560
8777,561728,43520,896,605248,562624
8778,561792,43456,896,605248,562688
8779,561856,43392,896,605248,562752
8780,561920,43328,896,605248,562816
8781,561984,43264,896,605248,562880
8782,562048,43200,896,605248,562944
8783,562112,43136,896,605248,563008
8784,562176,43072,896,605248,563072
8785,562240,43008,896,605248,563136
8786,562304,42944,896,605248,563200
8787,562368,42880,896,605248,563264
8788,562432,42816,896,605248,563328
8789,562496,42752,896,605248,563392
8790,562560,42688,896,605248,563456
8791,562624,42624,896,605248,563520
8792,562688,42560,896,605248,563584
8793,562752,42496,896,605248,563648
8794,562816,42432,896,605248,563712
8795,562880,42368,896,605248,563776
8796,562944,42304,896,605248,563840
8797,563008,42240,896,605248,563904
8798,563072,42176,896,605248,563968
8799,563136,42112,896,605248,564032
8800,563200,42048,896,605248,564096
8801,563264,41984,896,605248,564160
8802,563328,41920,896,605248,564224
8803,563392,41856,896,605248,564288
8804,563456,41792,896,605248,564352
8805,563520,41728,896,605248,564416
8806,563584,41664,896,605248,564480
8807,563648,41600,896,605248,564544
8808,563712,41536,896,605248,564608
8809,563776,41472,896,605248,564672
8810,563840,41408,896,605248,564736
8811,563904,41344,896,605248,564800
8812,563968,41280,896,605248,564864
8813,564032,41216,896,605248,564928
8814,564096,41152,896,605248,564992
8815,564160,41088,896,605248,565056
8816,564224,41024,896,605248,565120
8817,564288,40960,896,605248,565184
8818,564352,40896,896,605248,565248
8819,564416,40832,896,605248,565312
8820,564480,40768,896,605248,565376
8821,564544,40704,896,605248,565440
8822,564608,40640,896,605248,565504
8823,564672,40576,896,605248,565568
8824,564736,40512,896,605248,565632
8825,564800,40448,896,605248,565696
8826,564864,40384,896,605248,565760
8827,564928,40320,896,605248,565824
8828,564992,40256,896,605248,565888
8829,565056,40192,896,605248,565952
8830,565120,40128,896,605248,566016
8831,565184,40064,896,605248,566080
8832,565248,40000,896,605248,566144
8833,565312,39936,896,605248,566208
8834,565376,39872,896,605248,566272
8835,565440,39808,896,605248,566336
8836,565504,39744,896,605248,566400
8837,565568,39680,896,605248,566464
8838,565632,39616,896,605248,566528
8839,565696,39552,896,605248,566592
8840,565760,39488,896,605248,566656
8841,565824,39424,896,605248,566720
8842,565888,39360,896,605248,566784
8843,565952,39296,896,605248,566848
8844,566016,39232,896,605248,566912
8845,566080,39168,896,605248,566976
8846,566144,39104,896,605248,567040
8847,566208,39040,896,605248,567104
8848,566272,38976,896,605248,567168
8849,566336,38912,896,605248,567232
8850,566400,38848,896,605248,567296
8851,566464,38784,896,605248,567360
8852,566528,38720,896,605248,567424
8853,566592,38656,896,605248,567488
8854,566656,38592,896,605248,567552
8855,566720,38528,896,605248,567616
8856,566784,38464,896,605248,567680
8857,566848,38400,896,605248,567744
8858,566912,38336,896,605248,567808
8859,566976,38272,896,605248,567872
8860,567040,38208,896,605248,567936
8861,567104,38144,896,605248,568000
8862,567168,38080,896,605248,568064
8863,567232,38016,896,605248,568128
8864,567296,37952,896,605248,568192
8865,567360,37888,896,605248,568256
8866,567424,37824,896,605248,568320
8867,567488,37760,896,605248,568384
8868,567552,37696,896,605248,568448
8869,567616,37632,896,605248,568512
8870,567680,37568,896,605248,568576
8871,567744,37504,896,605248,568640
8872,567808,37440,896,605248,568704
8873,567872,37376,896,605248,568768
8874,567936,37312,896,605248,568832
8875,568000,37248,896,605248,568896
8876,568064,37184,896,605248,568960
8877,568128,37120,896,605248,569024
8878,568192,37056,896,605248,569088
8879,568256,36992,896,605248,569152
8880,568320,36928,896,605248,569216
8881,568384,36864,896,605248,569280
8882,568448,36800,896,605248,569344
8883,568512,36736,896,605248,569408
8884,568576,36672,896,605248,569472
8885,568640,36608,896,605248,569536
8886,568704,36544,896,605248,569600
8887,568768,36480,896,605248,569664
8888,568832,36416,896,605248,569728
8889,568896,36352,896,605248,569792
8890,568960,36288,896,605248,569856
8891,569024,36224,896,605248,569920
8892,569088,36160,896,605248,569984
8893,569152,36096,896,605248,570048
8894,569216,36032,896,605248,570112
8895,569280,35968,896,605248,570176
8896,569344,35904,896,605248,570240
8897,569408,35840,896,605248,570304
8898,569472,35776,896,605248,570368
8899,569536,35712,896,605248,570432
8900,569600,35648,896,605248,570496
8901,569664,35584,896,605248,570560
8902,569728,35520,896,605248,570624
8903,569792,35456,896,605248,570688
8904,569856,35392,896,605248,570752
8905,569920,35328,896,605248,570816
8906,569984,35264,896,605248,570880
8907,570048,35200,896,605248,570944
8908,570112,35136,896,605248,571008
8909,570176,35072,896,605248,571072
8910,570240,35008,896,605248,571136
8911,570304,34944,896,605248,571200
8912,570368,34880,896,605248,571264
8913,570432,34816,896,605248,571328
8914,570496,34752,896,605248,571392
8915,570560,34688,896,605248,571456
8916,570624,34624,896,605248,571520
8917,570688,34560,896,605248,571584
8918,570752,34496,896,605248,571648
8919,570816,34432,896,605248,571712
8920,570880,34368,896,605248,571776
8921,570944,34304,896,605248,571840
8922,571008,34240,896,605248,571904
8923,571072,34176,896,605248,571968
8924,571136,34112,896,605248,572032
8925,571200,34048,896,605248,572096
8926,571264,33984,896,605248,572160
8927,571328,33920,896,605248,572224
8928,571392,33856,896,605248,572288
8929,571456,33792,896,605248,572352
8930,571520,33728,896,605248,572416
8931,571584,33664,896,605248,572480
8932,571648,33600,896,605248,572544
8933,571712,33536,896,605248,572608
8934,571776,33472,896,605248,572672
8935,571840,33408,896,605248,572736
8936,571904,33344,896,605248,572800
8937,571968,33280,896,605248,572864
8938,572032,33216,896,605248,572928
8939,572096,33152,896,605248,572992
8940,572160,33088,896,605248,573056
8941,572224,33024,896,605248,573120
8942,572288,32960,896,605248,573184
8943,572352,32896,896,605248,573248
8944,572416,32832,896,605248,573312
8945,572480,32768,896,605248,573376
8946,572544,32704,896,605248,573440
8947,572608,32640,896,605248,573504
8948,572672,32576,896,605248,573568
8949,572736,32512,896,605248,573632
8950,572800,32448,896,605248,573696
8951,572864,32384,896,605248,573760
8952,572928,32320,896,605248,573824
8953,572992,32256,896,605248,573888
8954,573056,32192,896,605248,573952
8955,573120,32128,896,605248,574016
8956,573184,32064,896,605248,574080
8957,573248,32000,896,605248,574144
8958,573312,31936,896,605248,574208
8959,573376,31872,896,605248,574272
8960,573440,31808,896,605248,574336
8961,573504,31744,896,605248,574400
8962,573568,31680,896,605248,574464
8963,573632,31616,896,605248,574528
8964,573696,31552,896,605248,574592
8965,573760,31488,896,605248,574656
8966,573824,31424,896,605248,574720
8967,573888,31360,896,605248,574784
8968,573952,31296,896,605248,574848
8969,574016,31232,896,605248,574912
8970,574080,31168,896,605248,574976
8971,574144,31104,896,605248,575040
8972,574208,31040,896,605248,575104
8973,574272,30976,896,605248,575168
8974,574336,30912,896,605248,575232
8975,574400,30848,896,605248,575296
8976,574464,30784,896,605248,575360
8977,574528,30720,896,605248,575424
8978,574592,30656,896,605248,575488
8979,574656,30592,896,605248,575552
8980,574720,30528,896,605248,575616
8981,574784,30464,896,605248,575680
8982,574848,30400,896,605248,575744
8983,574912,30336,896,605248,575808
8984,574976,30272,896,605248,575872
8985,575040,30208,896,605248,575936
8986,575104,30144,896,605248,576000
8987,575168,30080,896,605248,576064
8988,575232,30016,896,605248,576128
8989,575296,29952,896,605248,576192
8990,575360,29888,896,605248,576256
8991,575424,29824,896,605248,576320
8992,575488,29760,896,605248,576384
8993,575552,29696,896,605248,576448
8994,575616,29632,896,605248,576512
8995,575680,29568,896,605248,576576
8996,575744,29504,896,605248,576640
8997,575808,29440,896,605248,576704
8998,575872,29376,896,605248,576768
8999,575936,29312,896,605248,576832
9000,576000,29248,896,605248,576896
9001,576064,29184,896,605248,576960
9002,576128,29120,896,605248,577024
9003,576192,29056,896,605248,577088
9004,576256,28992,896,605248,577152
9005,576320,28928,896,605248,577216
9006,576384,28864,896,605248,577280
9007,576448,28800,896,605248,577344
9008,576512,28736,896,605248,577408
9009,576576,28672,896,605248,577472
9010,576640,28608,896,605248,577536
9011,576704,28544,896,605248,577600
9012,576768,28480,896,605248,577664
9013,576832,28416,896,605248,577728
9014,576896,28352,896,605248,577792
9015,576960,28288,896,605248,577856
9016,577024,28224,896,605248,577920
9017,577088,28160,896,605248,577984
9018,577152,28096,896,605248,578048
9019,577216,28032,896,605248,578112
9020,577280,27968,896,605248,578176
9021,577344,27904,896,605248,578240
9022,577408,27840,896,605248,578304
9023,577472,27776,896,605248,578368
9024,577536,27712,896,605248,578432
9025,577600,27648,896,605248,578496
9026,577664,27584,896,605248,578560
9027,577728,27520,896,605248,578624
9028,577792,27456,896,605248,578688
9029,577856,27392,896,605248,578752
9030,577920,27328,896,605248,578816
9031,577984,27264,896,605248,578880
9032,578048,27200,896,605248,578944
9033,578112,27136,896,605248,579008
9034,578176,27072,896,605248,579072
9035,578240,27008,896,605248,579136
9036,578304,26944,896,605248,579200
9037,578368,26880,896,605248,579264
9038,578432,26816,896,605248,579328
9039,578496,26752,896,605248,579392
9040,578560,26688,896,605248,579456
9041,578624,26624,896,605248,579520
9042,578688,26560,896,605248,579584
9043,578752,26496,896,605248,579648
9044,578816,26432,896,605248,579712
9045,578880,26368,896,605248,579776
9046,578944,26304,896,605248,579840
9047,579008,26240,896,605248,579904
9048,579072,26176,896,605248,579968
9049,579136,26112,896,605248,580032
9050,579200,26048,896,605248,580096
9051,579264,25984,896,605248,580160
9052,579328,25920,896,605248,580224
9053,579392,25856,896,605248,580288
9054,579456,25792,896,605248,580352
9055,579520,25728,896,605248,580416
9056,579584,25664,896,605248,580480
9057,579648,25600,896,605248,580544
9058,579712,25536,896,605248,580608
9059,579776,25472,896,605248,580672
9060,579840,25408,896,605248,580736
9061,579904,25344,896,605248,580800
9062,579968,25280,896,605248,580864
9063,580032,25216,896,605248,580928
9064,580096,25152,896,605248,580992
9065,580160,25088,896,605248,581056
9066,580224,25024,896,605248,581120
9067,580288,24960,896,605248,581184
9068,580352,24896,896,605248,581248
9069,580416,24832,896,605248,581312
9070,580480,24768,896,605248,581376
9071,580544,24704,896,605248,581440
9072,580608,24640,896,605248,581504
9073,580672,24576,896,605248,581568
9074,580736,24512,896,605248,581632
9075,580800,24448,896,605248,581696
9076,580864,24384,896,605248,581760
9077,580928,24320,896,605248,581824
9078,580992,24256,896,605248,581888
9079,581056,24192,896,605248,581952
9080,581120,24128,896,605248,582016
9081,581184,24064,896,605248,582080
9082,581248,24000,896,605248,582144
9083,581312,23936,896,605248,582208
9084,581376,23872,896,605248,582272
9085,581440,23808,896,605248,582336
9086,581504,23744,896,605248,582400
9087,581568,23680,896,605248,582464
9088,581632,23616,896,605248,582528
9089,581696,23552,896,605248,582592
9090,581760,23488,896,605248,582656
9091,581824,23424,896,605248,582720
9092,581888,23360,896,605248,582784
9093,581952,23296,896,605248,582848
9094,582016,23232,896,605248,582912
9095,582080,23168,896,605248,582976
9096,582144,23104,896,605248,583040
9097,582208,23040,896,605248,583104
9098,582272,22976,896,605248,583168
9099,582336,22912,896,605248,583232
9100,582400,22848,896,605248,583296
9101,582464,22784,896,605248,583360
9102,582528,22720,896,605248,583424
9103,582592,22656,896,605248,583488
9104,582656,22592,896,605248,583552
9105,582720,22528,896,605248,583616
9106,582784,22464,896,605248,583680
9107,582848,22400,896,605248,583744
9108,582912,22336,896,605248,583808
9109,582976,22272,896,605248,583872
9110,583040,22208,896,605248,583936
9111,583104,22144,896,605248,584000
9112,583168,22080,896,605248,584064
9113,583232,22016,896,605248,584128
9114,583296,21952,896,605248,584192
9115,583360,21888,896,605248,584256
9116,583424,21824,896,605248,584320
9117,583488,21760,896,605248,584384
9118,583552,21696,896,605248,584448
9119,583616,21632,896,605248,584512
9120,583680,21568,896,605248,584576
9121,583744,21504,896,605248,584640
9122,583808,21440,896,605248,584704
9123,583872,21376,896,605248,584768
9124,583936,21312,896,605248,584832
9125,584000,21248,896,605248,584896
9126,584064,21184,896,605248,584960
9127,584128,21120,896,605248,585024
9128,584192,21056,896,605248,585088
9129,584256,20992,896,605248,585152
9130,584320,20928,896,605248,585216
9131,584384,20864,896,605248,585280
9132,584448,20800,896,605248,585344
9133,584512,20736,896,605248,585408
9134,584576,20672,896,605248,585472
9135,584640,20608,896,605248,585536
9136,584704,20544,896,605248,585600
9137,584768,20480,896,605248,585664
9138,584832,20416,896,605248,585728
9139,584896,20352,896,605248,585792
9140,584960,20288,896,605248,585856
9141,585024,20224,896,605248,585920
9142,585088,20160,896,605248,585984
9143,585152,20096,896,605248,586048
9144,585216,20032,896,605248,586112
9145,585280,19968,896,605248,586176
9146,585344,19904,896,605248,586240
9147,585408,19840,896,605248,586304
9148,585472,19776,896,605248,586368
9149,585536,19712,896,605248,586432
9150,585600,19648,896,605248,586496
9151,585664,19584,896,605248,586560
9152,585728,19520,896,605248,586624
9153,585792,19456,896,605248,586688
9154,585856,19392,896,605248,586752
9155,585920,19328,896,605248,586816
9156,585984,19264,896,605248,586880
9157,586048,19200,896,605248,586944
9158,586112,19136,896,605248,587008
9159,586176,19072,896,605248,587072
9160,586240,19008,896,605248,587136
9161,586304,18944,896,605248,587200
9162,586368,18880,896,605248,587264
9163,586432,18816,896,605248,587328
9164,586496,18752,896,605248,587392
9165,586560,18688,896,605248,587456
9166,586624,18624,896,605248,587520
9167,586688,18560,896,605248,587584
9168,586752,18496,896,605248,587648
9169,586816,18432,896,605248,587712
9170,586880,18368,896,605248,587776
9171,586944,18304,896,605248,587840
9172,587008,18240,896,605248,587904
9173,587072,18176,896,605248,587968
9174,587136,18112,896,605248,588032
9175,587200,18048,896,605248,588096
9176,587264,17984,896,605248,588160
9177,587328,17920,896,605248,588224
9178,587392,17856,896,605248,588288
9179,587456,17792,896,605248,588352
9180,587520,17728,896,605248,588416
9181,587584,17664,896,605248,588480
9182,587648,17600,896,605248,588544
9183,587712,17536,896,605248,588608
9184,587776,17472,896,605248,588672
9185,587840,17408,896,605248,588736
9186,587904,17344,896,605248,588800
9187,587968,17280,896,605248,588864
9188,588032,17216,896,605248,588928
9189,588096,17152,896,605248,588992
9190,588160,17088,896,605248,589056
9191,588224,17024,896,605248,589120
9192,588288,16960,896,605248,589184
9193,588352,16896,896,605248,589248
9194,588416,16832,896,605248,589312
9195,588480,16768,896,605248,589376
9196,588544,16704,896,605248,589440
9197,588608,16640,896,605248,589504
9198,588672,16576,896,605248,589568
9199,588736,16512,896,605248,589632
9200,588800,16448,896,605248,589696
9201,588864,16384,896,605248,589760
9202,588928,16320,896,605248,589824
9203,588992,16256,896,605248,589888
9204,589056,16192,896,605248,589952
9205,589120,16128,896,605248,590016
9206,589184,16064,896,605248,590080
9207,589248,16000,896,605248,590144
9208,589312,15936,896,605248,590208
9209,589376,15872,896,605248,590272
9210,589440,15808,896,605248,590336
9211,589504,15744,896,605248,590400
9212,589568,15680,896,605248,590464
9213,589632,15616,896,605248,590528
9214,589696,15552,896,605248,590592
9215,589760,15488,896,605248,590656
9216,589824,15424,896,605248,590720
9217,589888,15360,896,605248,590784
9218,589952,15296,896,605248,590848
9219,590016,15232,896,605248,590912
9220,590080,15168,896,605248,590976
9221,590144,15104,896,605248,591040
9222,590208,15040,896,605248,591104
9223,590272,14976,896,605248,591168
9224,590336,14912,896,605248,591232
9225,590400,14848,896,605248,591296
9226,590464,14784,896,605248,591360
9227,590528,14720,896,605248,591424
9228,590592,14656,896,605248,591488
9229,590656,14592,896,605248,591552
9230,590720,14528,896,605248,591616
9231,590784,14464,896,605248,591680
9232,590848,14400,896,605248,591744
9233,590912,14336,896,605248,591808
9234,590976,14272,896,605248,591872
9235,591040,14208,896,605248,591936
9236,591104,14144,896,605248,592000
9237,591168,14080,896,605248,592064
9238,591232,14016,896,605248,592128
9239,591296,13952,896,605248,592192
9240,591360,13888,896,605248,592256
9241,591424,13824,896,605248,592320
9242,591488,13760,896,605248,592384
9243,591552,13696,896,605248,592448
9244,591616,13632,896,605248,592512
9245,591680,13568,896,605248,592576
9246,591744,13504,896,605248,592640
9247,591808,13440,896,605248,592704
9248,591872,13376,896,605248,592768
9249,591936,13312,896,605248,592832
9250,592000,13248,896,605248,592896
9251,592064,13184,896,605248,592960
9252,592128,13120,896,605248,593024
9253,592192,13056,896,605248,593088
9254,592256,12992,896,605248,593152
9255,592320,12928,896,605248,593216
9256,592384,12864,896,605248,593280
9257,592448,12800,896,605248,593344
9258,592512,12736,896,605248,593408
9259,592576,12672,896,605248,593472
9260,592640,12608,896,605248,593536
9261,592704,12544,896,605248,593600
9262,592768,12480,896,605248,593664
9263,592832,12416,896,605248,593728
9264,592896,12352,896,605248,593792
9265,592960,12288,896,605248,593856
9266,593024,12224,896,605248,593920
9267,593088,12160,896,605248,593984
9268,593152,12096,896,605248,594048
9269,593216,12032,896,605248,594112
9270,593280,11968,896,605248,594176
9271,593344,11904,896,605248,594240
9272,593408,11840,896,605248,594304
9273,593472,11776,896,605248,594368
9274,593536,11712,896,605248,594432
9275,593600,11648,896,605248,594496
9276,593664,11584,896,605248,594560
9277,593728,11520,896,605248,594624
9278,593792,11456,896,605248,594688
9279,593856,11392,896,605248,594752
9280,593920,11328,896,605248,594816
9281,593984,11264,896,605248,594880
9282,594048,11200,896,605248,594944
9283,594112,11136,896,605248,595008
9284,594176,11072,896,605248,595072
9285,594240,11008,896,605248,595136
9286,594304,10944,896,605248,595200
9287,594368,10880,896,605248,595264
9288,594432,10816,896,605248,595328
9289,594496,10752,896,605248,595392
9290,594560,10688,896,605248,595456
9291,594624,10624,896,605248,595520
9292,594688,10560,896,605248,595584
9293,594752,10496,896,605248,595648
9294,594816,10432,896,605248,595712
9295,594880,10368,896,605248,595776
9296,594944,10304,896,605248,595840
9297,595008,10240,896,605248,595904
9298,595072,10176,896,605248,595968
9299,595136,10112,896,605248,596032
9300,595200,10048,896,605248,596096
9301,595264,9984,896,605248,596160
9302,595328,9920,896,605248,596224
9303,595392,9856,896,605248,596288
9304,595456,9792,896,605248,596352
9305,595520,9728,896,605248,596416
9306,595584,9664,896,605248,596480
9307,595648,9600,896,605248,596544
9308,595712,9536,896,605248,596608
9309,595776,9472,896,605248,596672
9310,595840,9408,896,605248,596736
9311,595904,9344,896,605248,596800
9312,595968,9280,896,605248,596864
9313,596032,9216,896,605248,596928
9314,596096,9152,896,605248,596992
9315,596160,9088,896,605248,597056
9316,596224,9024,896,605248,597120
9317,596288,8960,896,605248,597184
9318,596352,8896,896,605248,597248
9319,596416,8832,896,605248,597312
9320,596480,8768,896,605248,597376
9321,596544,8704,896,605248,597440
9322,596608,8640,896,605248,597504
9323,596672,8576,896,605248,597568
9324,596736,8512,896,605248,597632
9325,596800,8448,896,605248,597696
9326,596864,8384,896,605248,597760
9327,596928,8320,896,605248,597824
9328,596992,8256,896,605248,597888
9329,597056,8192,896,605248,597952
9330,597120,8128,896,605248,598016
9331,597184,8064,896,605248,598080
9332,597248,8000,896,605248,598144
9333,597312,7936,896,605248,598208
9334,597376,7872,896,605248,598272
9335,597440,7808,896,605248,598336
9336,597504,7744,896,605248,598400
9337,597568,7680,896,605248,598464
9338,597632,7616,896,605248,598528
9339,597696,7552,896,605248,598592
9340,597760,7488,896,605248,598656
9341,597824,7424,896,605248,598720
9342,597888,7360,896,605248,598784
9343,597952,7296,896,605248,598848
9344,598016,7232,896,605248,598912
9345,598080,7168,896,605248,598976
9346,598144,7104,896,605248,599040
9347,598208,7040,896,605248,599104
9348,598272,6976,896,605248,599168
9349,598336,6912,896,605248,599232
9350,598400,6848,896,605248,599296
9351,598464,6784,896,605248,599360
9352,598528,6720,896,605248,599424
9353,598592,6656,896,605248,599488
9354,598656,6592,896,605248,599552
9355,598720,6528,896,605248,599616
9356,598784,6464,896,605248,599680
9357,598848,6400,896,605248,599744
9358,598912,6336,896,605248,599808
9359,598976,6272,896,605248,599872
9360,599040,6208,896,605248,599936
9361,599104,6144,896,605248,600000
9362,599168,6080,896,605248,600064
9363,599232,6016,896,605248,600128
9364,599296,5952,896,605248,600192
9365,599360,5888,896,605248,600256
9366,599424,5824,896,605248,600320
9367,599488,5760,896,605248,600384
9368,599552,5696,896,605248,600448
9369,599616,5632,896,605248,600512
9370,599680,5568,896,605248,600576
9371,599744,5504,896,605248,600640
9372,599808,5440,896,605248,600704
9373,599872,5376,896,605248,600768
9374,599936,5312,896,605248,600832
9375,600000,5248,896,605248,600896
9376,600064,5184,896,605248,600960
9377,600128,5120,896,605248,601024
9378,600192,5056,896,605248,601088
9379,600256,4992,896,605248,601152
9380,600320,4928,896,605248,601216
9381,600384,4864,896,605248,601280
9382,600448,4800,896,605248,601344
9383,600512,4736,896,605248,601408
9384,600576,4672,896,605248,601472
9385,600640,4608,896,605248,601536
9386,600704,4544,896,605248,601600
9387,600768,4480,896,605248,601664
9388,600832,4416,896,605248,601728
9389,600896,4352,896,605248,601792
9390,600960,4288,896,605248,601856
9391,601024,4224,896,605248,601920
9392,601088,4160,896,605248,601984
9393,601152,4096,896,605248,602048
9394,601216,4032,896,605248,602112
9395,601280,3968,896,605248,602176
9396,601344,3904,896,605248,602240
9397,601408,3840,896,605248,602304
9398,601472,3776,896,605248,602368
9399,601536,3712,896,605248,602432
9400,601600,3648,896,605248,602496
9401,601664,3584,896,605248,602560
9402,601728,3520,896,605248,602624
9403,601792,3456,896,605248,602688
9404,601856,3392,896,605248,602752
9405,601920,3328,896,605248,602816
9406,601984,3264,896,605248,602880
9407,602048,3200,896,605248,602944
9408,602112,3136,896,605248,603008
9409,602176,3072,896,605248,603072
9410,602240,3008,896,605248,603136
9411,602304,2944,896,605248,603200
9412,602368,2880,896,605248,603264
9413,602432,2816,896,605248,603328
9414,602496,2752,896,605248,603392
9415,602560,2688,896,605248,603456
9416,602624,2624,896,605248,603520
9417,602688,2560,896,605248,603584
9418,602752,2496,896,605248,603648
9419,602816,2432,896,605248,603712
9420,602880,2368,896,605248,603776
9421,602944,2304,896,605248,603840
9422,603008,2240,896,605248,603904
9423,603072,2176,896,605248,603968
9424,603136,2112,896,605248,604032
9425,603200,2048,896,605248,604096
9426,603264,1984,896,605248,604160
9427,603328,1920,896,605248,604224
9428,603392,1856,896,605248,604288
9429,603456,1792,896,605248,604352
9430,603520,1728,896,605248,604416
9431,603584,1664,896,605248,604480
9432,603648,1600,896,605248,604544
9433,603712,1536,896,605248,604608
9434,603776,1472,896,605248,604672
9435,603840,1408,896,605248,604736
9436,603904,1344,896,605248,604800
9437,603968,1280,896,605248,604864
9438,604032,1216,896,605248,604928
9439,604096,1152,896,605248,604992
9440,604160,1088,896,605248,605056
9441,604224,1024,896,605248,605120
9442,604288,960,896,605248,605184
9443,604352,896,896,605248,605248
9444,604416,832,896,605248,605312
9445,604480,768,896,605248,605376
9446,604544,704,896,605248,605440
9447,604608,640,896,605248,605504
9448,604672,576,896,605248,605568
9449,604736,512,896,605248,605632
9450,604800,448,896,605248,605696
9451,604864,384,896,605248,605760
9452,604928,320,896,605248,605824
9453,604992,76288,896,681280,605888
9454,605056,76224,896,681280,605952
9455,605120,76160,896,681280,606016
9456,605184,76096,896,681280,606080
9457,605248,76032,896,681280,606144
9458,605312,75968,896,681280,606208
9459,605376,75904,896,681280,606272
9460,605440,75840,896,681280,606336
9461,605504,75776,896,681280,606400
9462,605568,75712,896,681280,606464
9463,605632,75648,896,681280,606528
9464,605696,75584,896,681280,606592
9465,605760,75520,896,681280,606656
9466,605824,75456,896,681280,606720
9467,605888,75392,896,681280,606784
9468,605952,75328,896,681280,606848
9469,606016,75264,896,681280,606912
9470,606080,75200,896,681280,606976
9471,606144,75136,896,681280,607040
9472,606208,75072,896,681280,607104
9473,606272,75008,896,681280,607168
9474,606336,74944,896,681280,607232
9475,606400,74880,896,681280,607296
9476,606464,74816,896,681280,607360
9477,606528,74752,896,681280,607424
9478,606592,74688,896,681280,607488
9479,606656,74624,896,681280,607552
9480,606720,74560,896,681280,607616
9481,606784,74496,896,681280,607680
9482,606848,74432,896,681280,607744
9483,606912,74368,896,681280,607808
9484,606976,74304,896,681280,607872
9485,607040,74240,896,681280,607936
9486,607104,74176,896,681280,608000
9487,607168,74112,896,681280,608064
9488,607232,74048,896,681280,608128
9489,607296,73984,896,681280,608192
9490,607360,73920,896,681280,608256
9491,607424,73856,896,681280,608320
9492,607488,73792,896,681280,608384
9493,607552,73728,896,681280,608448
9494,607616,73664,896,681280,608512
9495,607680,73600,896,681280,608576
9496,607744,73536,896,681280,608640
9497,607808,73472,896,681280,608704
9498,607872,73408,896,681280,608768
9499,607936,73344,896,681280,608832
9500,608000,73280,896,681280,608896
9501,608064,73216,896,681280,608960
9502,608128,73152,896,681280,609024
9503,608192,73088,896,681280,609088
9504,608256,73024,896,681280,609152
9505,608320,72960,896,681280,609216
9506,608384,72896,896,681280,609280
9507,608448,72832,896,681280,609344
9508,608512,72768,896,681280,609408
9509,608576,72704,896,681280,609472
9510,608640,72640,896,681280,609536
9511,608704,72576,896,681280,609600
9512,608768,72512,896,681280,609664
9513,608832,72448,896,681280,609728
9514,608896,72384,896,681280,609792
9515,608960,72320,896,681280,609856
9516,609024,72256,896,681280,609920
9517,609088,72192,896,681280,609984
9518,609152,72128,896,681280,610048
9519,609216,72064,896,681280,610112
9520,609280,72000,896,681280,610176
9521,609344,71936,896,681280,610240
9522,609408,71872,896,681280,610304
9523,609472,71808,896,681280,610368
9524,609536,71744,896,681280,610432
9525,609600,71680,896,681280,610496
9526,609664,71616,896,681280,610560
9527,609728,71552,896,681280,610624
9528,609792,71488,896,681280,610688
9529,609856,71424,896,681280,610752
9530,609920,71360,896,681280,610816
9531,609984,71296,896,681280,610880
9532,610048,71232,896,681280,610944
9533,610112,71168,896,681280,611008
9534,610176,71104,896,681280,611072
9535,610240,71040,896,681280,611136
9536,610304,70976,896,681280,611200
9537,610368,70912,896,681280,611264
9538,610432,70848,896,681280,611328
9539,610496,70784,896,681280,611392
9540,610560,70720,896,681280,611456
9541,610624,70656,896,681280,611520
9542,610688,70592,896,681280,611584
9543,610752,70528,896,681280,611648
9544,610816,70464,896,681280,611712
9545,610880,70400,896,681280,611776
9546,610944,70336,896,681280,611840
9547,611008,70272,896,681280,611904
9548,611072,70208,896,681280,611968
9549,611136,70144,896,681280,612032
9550,611200,70080,896,681280,612096
9551,611264,70016,896,681280,612160
9552,611328,69952,896,681280,612224
9553,611392,69888,896,681280,612288
9554,611456,69824,896,681280,612352
9555,611520,69760,896,681280,612416
9556,611584,69696,896,681280,612480
9557,611648,69632,896,681280,612544
9558,611712,69568,896,681280,612608
9559,611776,69504,896,681280,612672
9560,611840,69440,896,681280,612736
9561,611904,69376,896,681280,612800
9562,611968,69312,896,681280,612864
9563,612032,69248,896,681280,612928
9564,612096,69184,896,681280,612992
9565,612160,69120,896,681280,613056
9566,612224,69056,896,681280,613120
9567,612288,68992,896,681280,613184
9568,612352,68928,896,681280,613248
9569,612416,68864,896,681280,613312
9570,612480,68800,896,681280,613376
9571,612544,68736,896,681280,613440
9572,612608,68672,896,681280,613504
9573,612672,68608,896,681280,613568
9574,612736,68544,896,681280,613632
9575,612800,68480,896,681280,613696
9576,612864,68416,896,681280,613760
9577,612928,68352,896,681280,613824
9578,612992,68288,896,681280,613888
9579,613056,68224,896,681280,613952
9580,613120,68160,896,681280,614016
9581,613184,68096,896,681280,614080
9582,613248,68032,896,681280,614144
9583,613312,67968,896,681280,614208
9584,613376,67904,896,681280,614272
9585,613440,67840,896,681280,614336
9586,613504,67776,896,681280,614400
9587,613568,67712,896,681280,614464
9588,613632,67648,896,681280,614528
9589,613696,67584,896,681280,614592
9590,613760,67520,896,681280,614656
9591,613824,67456,896,681280,614720
9592,613888,67392,896,681280,614784
9593,613952,67328,896,681280,614848
9594,614016,67264,896,681280,614912
9595,614080,67200,896,681280,614976
9596,614144,67136,896,681280,615040
9597,614208,67072,896,681280,615104
9598,614272,67008,896,681280,615168
9599,614336,66944,896,681280,615232
9600,614400,66880,896,681280,615296
9601,614464,66816,896,681280,615360
9602,614528,66752,896,681280,615424
9603,614592,66688,896,681280,615488
9604,614656,66624,896,681280,615552
9605,614720,66560,896,681280,615616
9606,614784,66496,896,681280,615680
9607,614848,66432,896,681280,615744
9608,614912,66368,896,681280,615808
9609,614976,66304,896,681280,615872
9610,615040,66240,896,681280,615936
9611,615104,66176,896,681280,616000
9612,615168,66112,896,681280,616064
9613,615232,66048,896,681280,616128
9614,615296,65984,896,681280,616192
9615,615360,65920,896,681280,616256
9616,615424,65856,896,681280,616320
9617,615488,65792,896,681280,616384
9618,615552,65728,896,681280,616448
9619,615616,65664,896,681280,616512
9620,615680,65600,896,681280,616576
9621,615744,65536,896,681280,616640
9622,615808,65472,896,681280,616704
9623,615872,65408,896,681280,616768
9624,615936,65344,896,681280,616832
9625,616000,65280,896,681280,616896
9626,616064,65216,896,681280,616960
9627,616128,65152,896,681280,617024
9628,616192,65088,896,681280,617088
9629,616256,65024,896,681280,617152
9630,616320,64960,896,681280,617216
9631,616384,64896,896,681280,617280
9632,616448,64832,896,681280,617344
9633,616512,64768,896,681280,617408
9634,616576,64704,896,681280,617472
9635,616640,64640,896,681280,617536
9636,616704,64576,896,681280,617600
9637,616768,64512,896,681280,617664
9638,616832,64448,896,681280,617728
9639,616896,64384,896,681280,617792
9640,616960,64320,896,681280,617856
9641,617024,64256,896,681280,617920
9642,617088,64192,896,681280,617984
9643,617152,64128,896,681280,618048
9644,617216,64064,896,681280,618112
9645,617280,64000,896,681280,618176
9646,617344,63936,896,681280,618240
9647,617408,63872,896,681280,618304
9648,617472,63808,896,681280,618368
9649,617536,63744,896,681280,618432
9650,617600,63680,896,681280,618496
9651,617664,63616,896,681280,618560
9652,617728,63552,896,681280,618624
9653,617792,63488,896,681280,618688
9654,617856,63424,896,681280,618752
9655,617920,63360,896,681280,618816
9656,617984,63296,896,681280,618880
9657,618048,63232,896,681280,618944
9658,618112,63168,896,681280,619008
9659,618176,63104,896,681280,619072
9660,618240,63040,896,681280,619136
9661,618304,62976,896,681280,619200
9662,618368,62912,896,681280,619264
9663,618432,62848,896,681280,619328
9664,618496,62784,896,681280,619392
9665,618560,62720,896,681280,619456
9666,618624,62656,896,681280,619520
9667,618688,62592,896,681280,619584
9668,618752,62528,896,681280,619648
9669,618816,62464,896,681280,619712
9670,618880,62400,896,681280,619776
9671,618944,62336,896,681280,619840
9672,619008,62272,896,681280,619904
9673,619072,62208,896,681280,619968
9674,619136,62144,896,681280,620032
9675,619200,62080,896,681280,620096
9676,619264,62016,896,681280,620160
9677,619328,61952,896,681280,620224
9678,619392,61888,896,681280,620288
9679,619456,61824,896,681280,620352
9680,619520,61760,896,681280,620416
9681,619584,61696,896,681280,620480
9682,619648,61632,896,681280,620544
9683,619712,61568,896,681280,620608
9684,619776,61504,896,681280,620672
9685,619840,61440,896,681280,620736
9686,619904,61376,896,681280,620800
9687,619968,61312,896,681280,620864
9688,620032,61248,896,681280,620928
9689,620096,61184,896,681280,620992
9690,620160,61120,896,681280,621056
9691,620224,61056,896,681280,621120
9692,620288,60992,896,681280,621184
9693,620352,60928,896,681280,621248
9694,620416,60864,896,681280,621312
9695,620480,60800,896,681280,621376
9696,620544,60736,896,681280,621440
9697,620608,60672,896,681280,621504
9698,620672,60608,896,681280,621568
9699,620736,60544,896,681280,621632
9700,620800,60480,896,681280,621696
9701,620864,60416,896,681280,621760
9702,620928,60352,896,681280,621824
9703,620992,60288,896,681280,621888
9704,621056,60224,896,681280,621952
9705,621120,60160,896,681280,622016
9706,621184,60096,896,681280,622080
9707,621248,60032,896,681280,622144
9708,621312,59968,896,681280,622208
9709,621376,59904,896,681280,622272
9710,621440,59840,896,681280,622336
9711,621504,59776,896,681280,622400
9712,621568,59712,896,681280,622464
9713,621632,59648,896,681280,622528
9714,621696,59584,896,681280,622592
9715,621760,59520,896,681280,622656
9716,621824,59456,896,681280,622720
9717,621888,59392,896,681280,622784
9718,621952,59328,896,681280,622848
9719,622016,59264,896,681280,622912
9720,622080,59200,896,681280,622976
9721,622144,59136,896,681280,623040
9722,622208,59072,896,681280,623104
9723,622272,59008,896,681280,623168
9724,622336,58944,896,681280,623232
9725,622400,58880,896,681280,623296
9726,622464,58816,896,681280,623360
9727,622528,58752,896,681280,623424
9728,622592,58688,896,681280,623488
9729,622656,58624,896,681280,623552
9730,622720,58560,896,681280,623616
9731,622784,58496,896,681280,623680
9732,622848,58432,896,681280,623744
9733,622912,58368,896,681280,623808
9734,622976,58304,896,681280,623872
9735,623040,58240,896,681280,623936
9736,623104,58176,896,681280,624000
9737,623168,58112,896,681280,624064
9738,623232,58048,896,681280,624128
9739,623296,57984,896,681280,624192
9740,623360,57920,896,681280,624256
9741,623424,57856,896,681280,624320
9742,623488,57792,896,681280,624384
9743,623552,57728,896,681280,624448
9744,623616,57664,896,681280,624512
9745,623680,57600,896,681280,624576
9746,623744,57536,896,681280,624640
9747,623808,57472,896,681280,624704
9748,623872,57408,896,681280,624768
9749,623936,57344,896,681280,624832
9750,624000,57280,896,681280,624896
9751,624064,57216,896,681280,624960
9752,624128,57152,896,681280,625024
9753,624192,57088,896,681280,625088
9754,624256,57024,896,681280,625152
9755,624320,56960,896,681280,625216
9756,624384,56896,896,681280,625280
9757,624448,56832,896,681280,625344
9758,624512,56768,896,681280,625408
9759,624576,56704,896,681280,625472
9760,624640,56640,896,681280,625536
9761,624704,56576,896,681280,625600
9762,624768,56512,896,681280,625664
9763,624832,56448,896,681280,625728
9764,624896,56384,896,681280,625792
9765,624960,56320,896,681280,625856
9766,625024,56256,896,681280,625920
9767,625088,56192,896,681280,625984
9768,625152,56128,896,681280,626048
9769,625216,56064,896,681280,626112
9770,625280,56000,896,681280,626176
9771,625344,55936,896,681280,626240
9772,625408,55872,896,681280,626304
9773,625472,55808,896,681280,626368
9774,625536,55744,896,681280,626432
9775,625600,55680,896,681280,626496
9776,625664,55616,896,681280,626560
9777,625728,55552,896,681280,626624
9778,625792,55488,896,681280,626688
9779,625856,55424,896,681280,626752
9780,625920,55360,896,681280,626816
9781,625984,55296,896,681280,626880
9782,626048,55232,896,681280,626944
9783,626112,55168,896,681280,627008
9784,626176,55104,896,681280,627072
9785,626240,55040,896,681280,627136
9786,626304,54976,896,681280,627200
9787,626368,54912,896,681280,627264
9788,626432,54848,896,681280,627328
9789,626496,54784,896,681280,627392
9790,626560,54720,896,681280,627456
9791,626624,54656,896,681280,627520
9792,626688,54592,896,681280,627584
9793,626752,54528,896,681280,627648
9794,626816,54464,896,681280,627712
9795,626880,54400,896,681280,627776
9796,626944,54336,896,681280,627840
9797,627008,54272,896,681280,627904
9798,627072,54208,896,681280,627968
9799,627136,54144,896,681280,628032
9800,627200,54080,896,681280,628096
9801,627264,54016,896,681280,628160
9802,627328,53952,896,681280,628224
9803,627392,53888,896,681280,628288
9804,627456,53824,896,681280,628352
9805,627520,53760,896,681280,628416
9806,627584,53696,896,681280,628480
9807,627648,53632,896,681280,628544
9808,627712,53568,896,681280,628608
9809,627776,53504,896,681280,628672
9810,627840,53440,896,681280,628736
9811,627904,53376,896,681280,628800
9812,627968,53312,896,681280,628864
9813,628032,53248,896,681280,628928
9814,628096,53184,896,681280,628992
9815,628160,53120,896,681280,629056
9816,628224,53056,896,681280,629120
9817,628288,52992,896,681280,629184
9818,628352,52928,896,681280,629248
9819,628416,52864,896,681280,629312
9820,628480,52800,896,681280,629376
9821,628544,52736,896,681280,629440
9822,628608,52672,896,681280,629504
9823,628672,52608,896,681280,629568
9824,628736,52544,896,681280,629632
9825,628800,52480,896,681280,629696
9826,628864,52416,896,681280,629760
9827,628928,52352,896,681280,629824
9828,628992,52288,896,681280,629888
9829,629056,52224,896,681280,629952
9830,629120,52160,896,681280,630016
9831,629184,52096,896,681280,630080
9832,629248,52032,896,681280,630144
9833,629312,51968,896,681280,630208
9834,629376,51904,896,681280,630272
9835,629440,51840,896,681280,630336
9836,629504,51776,896,681280,630400
9837,629568,51712,896,681280,630464
9838,629632,51648,896,681280,630528
9839,629696,51584,896,681280,630592
9840,629760,51520,896,681280,630656
9841,629824,51456,896,681280,630720
9842,629888,51392,896,681280,630784
9843,629952,51328,896,681280,630848
9844,630016,51264,896,681280,630912
9845,630080,51200,896,681280,630976
9846,630144,51136,896,681280,631040
9847,630208,51072,896,681280,631104
9848,630272,51008,896,681280,631168
9849,630336,50944,896,681280,631232
9850,630400,50880,896,681280,631296
9851,630464,50816,896,681280,631360
9852,630528,50752,896,681280,631424
9853,630592,50688,896,681280,631488
9854,630656,50624,896,681280,631552
9855,630720,50560,896,681280,631616
9856,630784,50496,896,681280,631680
9857,630848,50432,896,681280,631744
9858,630912,50368,896,681280,631808
9859,630976,50304,896,681280,631872
9860,631040,50240,896,681280,631936
9861,631104,50176,896,681280,632000
9862,631168,50112,896,681280,632064
9863,631232,50048,896,681280,632128
9864,631296,49984,896,681280,632192
9865,631360,49920,896,681280,632256
9866,631424,49856,896,681280,632320
9867,631488,49792,896,681280,632384
9868,631552,49728,896,681280,632448
9869,631616,49664,896,681280,632512
9870,631680,49600,896,681280,632576
9871,631744,49536,896,681280,632640
9872,631808,49472,896,681280,632704
9873,631872,49408,896,681280,632768
9874,631936,49344,896,681280,632832
9875,632000,49280,896,681280,632896
9876,632064,49216,896,681280,632960
9877,632128,49152,896,681280,633024
9878,632192,49088,896,681280,633088
9879,632256,49024,896,681280,633152
9880,632320,48960,896,681280,633216
9881,632384,48896,896,681280,633280
9882,632448,48832,896,681280,633344
9883,632512,48768,896,681280,633408
9884,632576,48704,896,681280,633472
9885,632640,48640,896,681280,633536
9886,632704,48576,896,681280,633600
9887,632768,48512,896,681280,633664
9888,632832,48448,896,681280,633728
9889,632896,48384,896,681280,633792
9890,632960,48320,896,681280,633856
9891,633024,48256,896,681280,633920
9892,633088,48192,896,681280,633984
9893,633152,48128,896,681280,634048
9894,633216,48064,896,681280,634112
9895,633280,48000,896,681280,634176
9896,633344,47936,896,681280,634240
9897,633408,47872,896,681280,634304
9898,633472,47808,896,681280,634368
9899,633536,47744,896,681280,634432
9900,633600,47680,896,681280,634496
9901,633664,47616,896,681280,634560
9902,633728,47552,896,681280,634624
9903,633792,47488,896,681280,634688
9904,633856,47424,896,681280,634752
9905,633920,47360,896,681280,634816
9906,633984,47296,896,681280,634880
9907,634048,47232,896,681280,634944
9908,634112,47168,896,681280,635008
9909,634176,47104,896,681280,635072
9910,634240,47040,896,681280,635136
9911,634304,46976,896,681280,635200
9912,634368,46912,896,681280,635264
9913,634432,46848,896,681280,635328
9914,634496,46784,896,681280,635392
9915,634560,46720,896,681280,635456
9916,634624,46656,896,681280,635520
9917,634688,46592,896,681280,635584
9918,634752,46528,896,681280,635648
9919,634816,46464,896,681280,635712
9920,634880,46400,896,681280,635776
9921,634944,46336,896,681280,635840
9922,635008,46272,896,681280,635904
9923,635072,46208,896,681280,635968
9924,635136,46144,896,681280,636032
9925,635200,46080,896,681280,636096
9926,635264,46016,896,681280,636160
9927,635328,45952,896,681280,636224
9928,635392,45888,896,681280,636288
9929,635456,45824,896,681280,636352
9930,635520,45760,896,681280,636416
9931,635584,45696,896,681280,636480
9932,635648,45632,896,681280,636544
9933,635712,45568,896,681280,636608
9934,635776,45504,896,681280,636672
9935,635840,45440,896,681280,636736
9936,635904,45376,896,681280,636800
9937,635968,45312,896,681280,636864
9938,636032,45248,896,681280,636928
9939,636096,45184,896,681280,636992
9940,636160,45120,896,681280,637056
9941,636224,45056,896,681280,637120
9942,636288,44992,896,681280,637184
9943,636352,44928,896,681280,637248
9944,636416,44864,896,681280,637312
9945,636480,44800,896,681280,637376
9946,636544,44736,896,681280,637440
9947,636608,44672,896,681280,637504
9948,636672,44608,896,681280,637568
9949,636736,44544,896,681280,637632
9950,636800,44480,896,681280,637696
9951,636864,44416,896,681280,637760
9952,636928,44352,896,681280,637824
9953,636992,44288,896,681280,637888
9954,637056,44224,896,681280,637952
9955,637120,44160,896,681280,638016
9956,637184,44096,896,681280,638080
9957,637248,44032,896,681280,638144
9958,637312,43968,896,681280,638208
9959,637376,43904,896,681280,638272
9960,637440,43840,896,681280,638336
9961,637504,43776,896,681280,638400
9962,637568,43712,896,681280,638464
9963,637632,43648,896,681280,638528
9964,637696,43584,896,681280,638592
9965,637760,43520,896,681280,638656
9966,637824,43456,896,681280,638720
9967,637888,43392,896,681280,638784
9968,637952,43328,896,681280,638848
9969,638016,43264,896,681280,638912
9970,638080,43200,896,681280,638976
9971,638144,43136,896,681280,639040
9972,638208,43072,896,681280,639104
9973,638272,43008,896,681280,639168
9974,638336,42944,896,681280,639232
9975,638400,42880,896,681280,639296
9976,638464,42816,896,681280,639360
9977,638528,42752,896,681280,639424
9978,638592,42688,896,681280,639488
9979,638656,42624,896,681280,639552
9980,638720,42560,896,681280,639616
9981,638784,42496,896,681280,639680
9982,638848,42432,896,681280,639744
9983,638912,42368,896,681280,639808
9984,638976,42304,896,681280,639872
9985,639040,42240,896,681280,639936
9986,639104,42176,896,681280,640000
9987,639168,42112,896,681280,640064
9988,639232,42048,896,681280,640128
9989,639296,41984,896,681280,640192
9990,639360,41920,896,681280,640256
9991,639424,41856,896,681280,640320
9992,639488,41792,896,681280,640384
9993,639552,41728,896,681280,640448
9994,639616,41664,896,681280,640512
9995,639680,41600,896,681280,640576
9996,639744,41536,896,681280,640640
9997,639808,41472,896,681280,640704
9998,639872,41408,896,681280,640768
9999,639936,41344,896,681280,640832
10000,640000,41280,896,681280,640896
